CTYNAME,AGEGRP,TOT_POP,TOT_MALE,TOT_FEMALE,WA_MALE,WA_FEMALE,BA_MALE,BA_FEMALE,IA_MALE,IA_FEMALE,AA_MALE,AA_FEMALE,NA_MALE,NA_FEMALE,TOM_MALE,TOM_FEMALE,NH_MALE,NH_FEMALE,H_MALE,H_FEMALE
Anderson,5,3404,2195,1209,1491,933,624,203,10,12,26,14,1,4,43,43,1593,931,602,278
Anderson,6,4493,3150,1343,2005,1067,1047,219,9,15,47,13,2,2,40,27,2271,1075,879,268
Anderson,7,4857,3564,1293,2197,1018,1265,233,9,6,42,20,10,3,41,13,2626,1062,938,231
Anderson,8,4708,3404,1304,2100,1053,1205,200,30,9,38,20,5,4,26,18,2637,1090,767,214
Anderson,9,4624,3369,1255,2118,1054,1158,169,21,8,30,17,7,2,35,5,2690,1001,679,254
Anderson,10,4434,3077,1357,1961,1090,1020,212,32,13,36,21,2,2,26,19,2555,1143,522,214
Anderson,11,3890,2550,1340,1752,1108,760,199,13,7,9,11,1,7,15,8,2199,1186,351,154
Anderson,12,3576,2123,1453,1573,1199,506,212,12,13,12,12,2,2,18,15,1898,1311,225,142
Anderson,13,3265,1710,1555,1373,1312,293,203,18,16,10,13,0,0,16,11,1567,1457,143,98
Anderson,14,2760,1401,1359,1189,1177,176,156,14,7,4,3,2,0,16,16,1299,1275,102,84
Anderson,15,2217,1081,1136,962,1017,102,103,5,4,3,5,0,0,9,7,1027,1092,54,44
Anderson,16,1675,764,911,687,780,67,116,6,3,0,3,0,0,4,9,720,869,44,42
Anderson,17,949,369,580,316,502,44,69,4,3,1,1,0,1,4,4,358,567,11,13
Anderson,18,866,329,537,282,436,38,88,4,4,0,5,0,0,5,4,319,514,10,23
Andrews,5,1145,622,523,573,492,13,11,17,7,7,3,1,0,11,10,201,170,421,353
Andrews,6,1367,748,619,693,599,22,8,16,6,4,1,0,0,13,5,260,250,488,369
Andrews,7,1306,667,639,631,610,11,11,8,10,3,4,0,0,14,4,244,269,423,370
Andrews,8,1336,712,624,667,590,18,9,12,9,7,10,0,0,8,6,306,289,406,335
Andrews,9,1060,530,530,500,503,7,6,10,11,3,4,0,0,10,6,205,224,325,306
Andrews,10,1029,512,517,490,498,9,4,5,7,4,2,0,0,4,6,215,221,297,296
Andrews,11,1003,511,492,484,466,11,12,9,5,4,7,1,0,2,2,234,249,277,243
Andrews,12,1034,545,489,517,468,10,0,6,7,6,4,1,1,5,9,285,292,260,197
Andrews,13,867,439,428,418,402,6,5,8,11,3,4,0,0,4,6,275,257,164,171
Andrews,14,590,291,299,274,274,7,8,5,9,3,4,0,0,2,4,175,199,116,100
Andrews,15,451,212,239,195,228,5,2,9,7,0,2,0,0,3,0,133,161,79,78
Andrews,16,311,132,179,127,169,3,6,1,0,0,1,0,0,1,3,88,130,44,49
Andrews,17,236,88,148,85,145,1,0,1,3,1,0,0,0,0,0,58,108,30,40
Andrews,18,222,94,128,91,121,1,2,1,2,0,1,0,0,1,2,66,105,28,23
Angelina,5,5397,2697,2700,2172,2086,417,486,18,31,28,40,1,3,61,54,1864,1930,833,770
Angelina,6,5823,2842,2981,2244,2299,507,586,33,20,29,27,2,1,27,48,2064,2256,778,725
Angelina,7,5326,2571,2755,2099,2166,406,489,14,22,24,40,7,3,21,35,1915,2110,656,645
Angelina,8,5298,2548,2750,2119,2217,365,460,13,20,19,30,3,3,29,20,1872,2109,676,641
Angelina,9,4966,2408,2558,1939,2062,386,418,21,22,36,35,7,2,19,19,1815,1916,593,642
Angelina,10,5400,2695,2705,2238,2198,411,439,13,28,21,26,1,1,11,13,2117,2182,578,523
Angelina,11,5366,2691,2675,2188,2160,418,434,29,23,41,34,2,1,13,23,2189,2207,502,468
Angelina,12,5589,2829,2760,2317,2277,444,429,28,18,24,23,0,0,16,13,2339,2405,490,355
Angelina,13,5171,2494,2677,2086,2185,361,416,16,31,17,27,1,1,13,17,2158,2376,336,301
Angelina,14,4401,2072,2329,1805,1969,216,314,14,14,27,15,1,1,9,16,1841,2135,231,194
Angelina,15,3655,1631,2024,1434,1731,162,228,5,11,15,41,2,2,13,11,1515,1873,116,151
Angelina,16,2575,1157,1418,1021,1247,105,143,15,5,4,16,0,0,12,7,1059,1323,98,95
Angelina,17,1811,762,1049,668,922,62,111,3,4,25,6,0,0,4,6,720,996,42,53
Angelina,18,1695,661,1034,583,907,43,108,9,5,14,12,0,0,12,2,603,990,58,44
Aransas,5,1097,604,493,552,446,12,17,8,9,14,12,1,0,17,9,323,285,281,208
Aransas,6,1110,552,558,497,519,14,11,9,11,17,11,0,0,15,6,304,353,248,205
Aransas,7,1072,550,522,513,486,16,6,5,8,10,12,1,0,5,10,364,339,186,183
Aransas,8,1133,574,559,524,518,14,6,9,12,6,13,1,1,20,9,342,353,232,206
Aransas,9,1063,532,531,488,494,14,3,9,15,12,11,1,1,8,7,336,352,196,179
Aransas,10,1314,640,674,586,630,21,9,12,8,7,18,2,0,12,9,453,499,187,175
Aransas,11,1426,664,762,599,718,11,11,20,6,27,20,0,1,7,6,483,571,181,191
Aransas,12,1917,925,992,856,946,24,10,10,8,22,20,1,0,12,8,717,774,208,218
Aransas,13,1950,915,1035,874,981,15,12,4,10,16,22,0,0,6,10,761,884,154,151
Aransas,14,1940,934,1006,886,943,14,7,15,10,12,26,1,1,6,19,796,866,138,140
Aransas,15,1844,893,951,846,918,7,9,8,6,18,9,0,0,14,9,792,838,101,113
Aransas,16,1473,711,762,686,730,7,5,6,11,5,10,0,1,7,5,651,684,60,78
Aransas,17,820,399,421,382,403,4,2,7,6,3,4,0,0,3,6,354,363,45,58
Aransas,18,689,320,369,306,356,1,3,3,1,4,3,0,1,6,5,298,324,22,45
Archer,5,451,247,204,231,190,6,1,6,7,0,3,0,0,4,3,216,178,31,26
Archer,6,441,239,202,217,193,3,1,10,5,0,0,0,0,9,3,200,176,39,26
Archer,7,483,226,257,223,249,2,0,0,5,0,0,0,0,1,3,203,236,23,21
Archer,8,486,269,217,247,203,7,3,5,4,1,4,0,1,9,2,243,199,26,18
Archer,9,488,223,265,218,248,1,6,1,5,2,4,0,0,1,2,205,239,18,26
Archer,10,538,240,298,228,285,4,4,3,6,2,1,0,0,3,2,220,271,20,27
Archer,11,605,318,287,301,283,4,0,6,1,2,1,0,0,5,2,301,273,17,14
Archer,12,714,346,368,332,358,3,1,6,3,1,4,1,0,3,2,321,349,25,19
Archer,13,697,330,367,319,352,3,5,5,4,0,2,0,0,3,4,316,359,14,8
Archer,14,525,243,282,234,268,0,3,4,3,1,2,0,0,4,6,235,278,8,4
Archer,15,414,200,214,195,208,2,0,0,3,1,1,0,0,2,2,194,212,6,2
Archer,16,340,161,179,158,175,1,2,1,0,0,1,0,0,1,1,157,171,4,8
Archer,17,229,101,128,99,126,1,0,1,2,0,0,0,0,0,0,100,124,1,4
Archer,18,195,86,109,85,107,0,0,1,1,0,0,0,0,0,1,83,104,3,5
Armstrong,5,77,43,34,42,31,1,1,0,2,0,0,0,0,0,0,39,31,4,3
Armstrong,6,89,47,42,43,41,3,0,1,1,0,0,0,0,0,0,40,37,7,5
Armstrong,7,87,39,48,39,45,0,1,0,1,0,0,0,0,0,1,37,47,2,1
Armstrong,8,113,54,59,51,56,0,0,0,2,2,1,0,0,1,0,52,55,2,4
Armstrong,9,112,61,51,58,47,1,2,1,0,0,0,0,0,1,2,53,47,8,4
Armstrong,10,112,60,52,60,52,0,0,0,0,0,0,0,0,0,0,48,41,12,11
Armstrong,11,81,43,38,43,36,0,0,0,1,0,0,0,0,0,1,41,37,2,1
Armstrong,12,145,63,82,59,82,0,0,3,0,0,0,0,0,1,0,58,79,5,3
Armstrong,13,152,78,74,75,72,0,0,2,1,0,0,0,0,1,1,72,71,6,3
Armstrong,14,137,68,69,68,68,0,0,0,1,0,0,0,0,0,0,67,64,1,5
Armstrong,15,117,61,56,59,49,2,0,0,5,0,0,0,0,0,2,56,51,5,5
Armstrong,16,83,34,49,34,49,0,0,0,0,0,0,0,0,0,0,33,49,1,0
Armstrong,17,67,25,42,25,40,0,0,0,2,0,0,0,0,0,0,25,40,0,2
Armstrong,18,40,10,30,10,29,0,0,0,0,0,0,0,0,0,1,10,30,0,0
Atascosa,5,3166,1578,1588,1508,1523,32,22,16,12,7,6,3,5,12,20,398,438,1180,1150
Atascosa,6,3232,1644,1588,1579,1524,13,17,19,17,13,12,3,3,17,15,496,538,1148,1050
Atascosa,7,3265,1716,1549,1632,1471,29,21,28,27,15,15,1,0,11,15,537,479,1179,1070
Atascosa,8,3348,1649,1699,1581,1629,25,16,18,27,9,8,1,4,15,15,553,570,1096,1129
Atascosa,9,2976,1514,1462,1443,1406,29,17,23,18,5,7,1,0,13,14,508,503,1006,959
Atascosa,10,3091,1529,1562,1467,1496,14,12,22,22,9,16,4,3,13,13,576,543,953,1019
Atascosa,11,2905,1471,1434,1393,1392,24,15,25,10,11,4,0,0,18,13,575,530,896,904
Atascosa,12,3131,1515,1616,1443,1547,23,10,26,23,13,13,2,3,8,20,600,701,915,915
Atascosa,13,2771,1366,1405,1308,1350,11,10,26,17,4,12,1,1,16,15,583,646,783,759
Atascosa,14,2382,1140,1242,1094,1196,8,15,19,11,11,5,1,1,7,14,527,625,613,617
Atascosa,15,1950,950,1000,916,969,11,5,10,10,4,2,2,1,7,13,462,487,488,513
Atascosa,16,1360,642,718,624,682,4,7,9,12,2,7,0,4,3,6,342,375,300,343
Atascosa,17,865,384,481,369,470,3,4,7,3,0,1,0,0,5,3,187,248,197,233
Atascosa,18,801,279,522,270,507,5,1,3,6,0,4,0,0,1,4,155,317,124,205
Austin,5,1658,851,807,730,669,100,103,7,8,1,10,0,0,13,17,556,513,295,294
Austin,6,1737,876,861,726,753,111,81,10,7,9,10,0,1,20,9,543,549,333,312
Austin,7,1642,835,807,727,707,80,70,7,9,7,12,1,1,13,8,536,520,299,287
Austin,8,1663,794,869,676,749,92,91,11,10,9,11,0,0,6,8,515,594,279,275
Austin,9,1666,850,816,750,724,71,71,15,3,10,13,0,0,4,5,574,583,276,233
Austin,10,1736,838,898,742,793,72,79,8,10,8,7,0,0,8,9,598,656,240,242
Austin,11,1913,962,951,835,826,105,99,6,6,9,13,1,0,6,7,728,753,234,198
Austin,12,2099,1069,1030,943,916,94,98,14,7,9,6,0,0,9,3,855,861,214,169
Austin,13,2274,1136,1138,1015,1017,93,95,6,8,8,7,2,1,12,10,958,981,178,157
Austin,14,1837,929,908,861,826,53,63,5,4,2,4,0,0,8,11,828,814,101,94
Austin,15,1542,733,809,679,743,41,62,2,1,3,2,0,0,8,1,665,746,68,63
Austin,16,1115,549,566,521,510,18,47,1,5,4,1,0,0,5,3,502,526,47,40
Austin,17,600,275,325,257,292,15,24,1,3,1,1,0,0,1,5,255,304,20,21
Austin,18,640,232,408,209,362,19,39,0,3,0,0,0,0,4,4,209,380,23,28
Bailey,5,442,231,211,214,189,5,6,9,11,1,2,0,1,2,2,52,50,179,161
Bailey,6,397,198,199,179,184,8,5,8,6,2,2,0,1,1,1,53,46,145,153
Bailey,7,429,215,214,189,195,5,1,15,10,2,2,0,1,4,5,71,77,144,137
Bailey,8,396,200,196,187,183,7,5,3,6,1,1,0,0,2,1,68,65,132,131
Bailey,9,449,230,219,214,206,6,0,7,12,1,1,0,0,2,0,61,59,169,160
Bailey,10,340,167,173,149,160,6,3,9,5,2,2,0,1,1,2,50,50,117,123
Bailey,11,370,182,188,171,174,2,3,4,8,4,0,0,2,1,1,73,64,109,124
Bailey,12,401,207,194,192,189,5,1,8,3,2,1,0,0,0,0,83,97,124,97
Bailey,13,373,203,170,189,163,7,1,4,5,0,0,1,0,2,1,118,101,85,69
Bailey,14,310,150,160,143,156,2,1,2,1,0,1,0,0,3,1,88,107,62,53
Bailey,15,231,118,113,110,107,3,1,3,1,1,1,0,1,1,2,79,75,39,38
Bailey,16,189,90,99,89,95,0,0,1,2,0,0,0,0,0,2,64,69,26,30
Bailey,17,158,65,93,62,91,1,1,2,0,0,1,0,0,0,0,44,70,21,23
Bailey,18,128,54,74,49,69,3,4,0,1,1,0,0,0,1,0,39,58,15,16
Bandera,5,996,509,487,476,461,4,6,11,10,1,2,0,0,17,8,346,345,163,142
Bandera,6,951,508,443,480,419,4,4,10,6,2,4,2,0,10,10,366,328,142,115
Bandera,7,1052,533,519,497,495,11,5,11,3,6,0,1,0,7,16,386,379,147,140
Bandera,8,1094,541,553,518,522,3,10,11,8,3,5,0,0,6,8,409,436,132,117
Bandera,9,1058,513,545,488,522,10,10,8,2,4,2,0,0,3,9,396,407,117,138
Bandera,10,1298,637,661,608,621,11,10,9,9,4,6,0,0,5,15,490,514,147,147
Bandera,11,1584,752,832,726,807,8,3,9,12,3,4,1,1,5,5,604,682,148,150
Bandera,12,2193,1003,1190,964,1148,12,7,14,13,1,11,1,0,11,11,853,997,150,193
Bandera,13,2230,1069,1161,1034,1123,10,12,11,11,4,7,0,0,10,8,930,1014,139,147
Bandera,14,2101,1030,1071,1001,1028,5,8,17,9,1,12,1,0,5,14,917,965,113,106
Bandera,15,1721,886,835,853,804,6,4,17,12,4,5,0,0,6,10,778,741,108,94
Bandera,16,1147,587,560,569,544,1,2,10,7,3,3,0,0,4,4,541,503,46,57
Bandera,17,618,318,300,309,288,2,1,2,4,2,3,0,0,3,4,281,263,37,37
Bandera,18,557,249,308,243,303,1,0,2,1,1,0,0,0,2,4,215,287,34,21
Bastrop,5,5079,2668,2411,2302,2085,201,191,76,56,29,23,2,3,58,53,1274,1207,1394,1204
Bastrop,6,5206,2816,2390,2364,2087,302,162,63,62,27,25,8,4,52,50,1518,1311,1298,1079
Bastrop,7,5272,2766,2506,2357,2191,277,165,49,78,21,25,5,6,57,41,1534,1466,1232,1040
Bastrop,8,5290,2752,2538,2356,2230,240,187,77,53,35,34,3,3,41,31,1626,1497,1126,1041
Bastrop,9,5173,2710,2463,2351,2176,213,146,52,44,37,45,4,3,53,49,1559,1441,1151,1022
Bastrop,10,5462,2798,2664,2435,2359,220,187,69,52,36,29,1,3,37,34,1741,1692,1057,972
Bastrop,11,5626,2873,2753,2478,2395,244,238,80,42,30,29,7,7,34,42,1944,1964,929,789
Bastrop,12,6193,3152,3041,2801,2687,231,225,54,46,30,41,5,2,31,40,2307,2309,845,732
Bastrop,13,5884,2925,2959,2633,2669,198,192,37,37,20,21,3,2,34,38,2270,2445,655,514
Bastrop,14,4864,2431,2433,2203,2191,147,169,32,25,13,16,2,2,34,30,2042,2092,389,341
Bastrop,15,3645,1746,1899,1613,1688,96,143,15,26,6,15,3,0,13,27,1488,1635,258,264
Bastrop,16,2130,984,1146,889,1036,70,83,9,8,3,5,1,1,12,13,855,982,129,164
Bastrop,17,1388,588,800,528,712,35,64,5,4,9,7,0,0,11,13,499,705,89,95
Bastrop,18,1158,439,719,393,629,30,62,9,10,2,3,0,1,5,14,373,624,66,95
Baylor,5,163,97,66,87,60,2,2,2,0,0,0,0,0,6,4,77,51,20,15
Baylor,6,200,88,112,79,105,5,4,1,0,1,2,0,0,2,1,67,96,21,16
Baylor,7,177,80,97,75,94,4,2,0,1,0,0,0,0,1,0,69,89,11,8
Baylor,8,210,113,97,105,89,1,4,6,1,1,1,0,0,0,2,87,74,26,23
Baylor,9,181,92,89,91,85,0,3,0,0,0,0,0,0,1,1,71,77,21,12
Baylor,10,190,92,98,87,96,4,0,1,0,0,1,0,0,0,1,84,85,8,13
Baylor,11,218,97,121,92,114,3,4,1,2,0,0,0,0,1,1,88,105,9,16
Baylor,12,233,127,106,124,101,2,5,1,0,0,0,0,0,0,0,115,88,12,18
Baylor,13,262,128,134,122,127,3,4,1,0,0,0,0,1,2,2,116,116,12,18
Baylor,14,229,111,118,106,112,2,1,0,2,0,0,0,1,3,2,104,113,7,5
Baylor,15,181,79,102,74,96,4,3,0,0,0,1,1,0,0,2,73,97,6,5
Baylor,16,181,81,100,80,94,0,4,0,0,1,1,0,0,0,1,77,92,4,8
Baylor,17,114,49,65,46,62,3,1,0,0,0,2,0,0,0,0,45,61,4,4
Baylor,18,142,44,98,41,92,3,0,0,1,0,0,0,0,0,5,42,96,2,2
Bee,5,2687,1899,788,1521,738,351,21,4,9,10,4,2,2,11,14,814,168,1085,620
Bee,6,2914,2072,842,1702,789,324,27,16,4,12,7,4,1,14,14,960,277,1112,565
Bee,7,2756,1953,803,1577,740,341,25,12,12,8,14,4,2,11,10,969,239,984,564
Bee,8,2679,1904,775,1546,736,328,20,7,7,10,3,4,1,9,8,942,216,962,559
Bee,9,2252,1560,692,1202,647,327,13,14,17,6,6,2,1,9,8,893,210,667,482
Bee,10,2177,1498,679,1154,632,315,17,10,8,5,10,1,0,13,12,843,219,655,460
Bee,11,1892,1175,717,956,697,188,3,16,4,8,6,1,0,6,7,622,239,553,478
Bee,12,1767,978,789,839,744,111,23,14,13,5,6,0,0,9,3,491,335,487,454
Bee,13,1549,807,742,740,707,50,14,8,4,2,9,0,0,7,8,401,324,406,418
Bee,14,1255,621,634,592,603,23,8,3,7,1,7,0,1,2,8,320,290,301,344
Bee,15,1059,518,541,496,514,8,9,5,7,5,4,0,2,4,5,271,276,247,265
Bee,16,724,319,405,304,389,8,7,3,2,2,6,0,0,2,1,187,205,132,200
Bee,17,537,239,298,229,286,4,4,2,3,3,2,0,0,1,3,133,153,106,145
Bee,18,428,151,277,147,263,1,2,2,5,1,5,0,0,0,2,98,162,53,115
Bell,5,30213,16699,13514,10981,8434,4090,3581,220,176,432,385,134,99,842,839,12282,9549,4417,3965
Bell,6,31637,16492,15145,10664,9546,4398,4147,200,184,540,457,108,130,582,681,12248,11146,4244,3999
Bell,7,27360,13617,13743,9124,8828,3333,3505,155,146,421,569,130,161,454,534,9843,10109,3774,3634
Bell,8,25388,12524,12864,8320,8195,3138,3367,129,130,407,518,148,168,382,486,8983,9302,3541,3562
Bell,9,20904,10251,10653,6729,6835,2662,2740,128,131,304,453,113,117,315,377,7464,7857,2787,2796
Bell,10,19553,9463,10090,6364,6574,2454,2578,97,123,274,438,75,76,199,301,7305,7823,2158,2267
Bell,11,18480,9005,9475,6193,6201,2283,2475,118,97,220,430,40,69,151,203,7147,7593,1858,1882
Bell,12,18472,8569,9903,5961,6755,2148,2425,89,103,173,407,52,71,146,142,6946,8087,1623,1816
Bell,13,16349,7635,8714,5481,6135,1751,1722,87,67,178,601,50,64,88,125,6327,7326,1308,1388
Bell,14,12950,5958,6992,4648,5150,994,1180,60,48,143,465,44,55,69,94,5082,6046,876,946
Bell,15,10160,4660,5500,3800,4278,635,760,50,38,108,336,32,28,35,60,4087,4794,573,706
Bell,16,6706,3032,3674,2547,2968,346,486,23,9,67,164,20,6,29,41,2685,3283,347,391
Bell,17,4270,1806,2464,1531,2076,204,248,17,7,29,103,5,10,20,20,1605,2182,201,282
Bell,18,4395,1650,2745,1434,2357,148,258,10,9,27,97,7,1,24,23,1463,2489,187,256
Bexar,5,145170,74926,70244,62458,58442,7034,6421,1046,977,2139,2159,190,196,2059,2049,27942,23828,46984,46416
Bexar,6,162321,83488,78833,68852,64738,8075,7621,1173,1079,3218,3151,205,205,1965,2039,33600,30643,49888,48190
Bexar,7,154959,79157,75802,66169,62953,7103,6682,1098,1051,2920,3230,210,197,1657,1689,31387,29709,47770,46093
Bexar,8,143606,72453,71153,60327,59595,6608,6078,1010,889,2790,2948,211,188,1507,1455,28534,26989,43919,44164
Bexar,9,124893,61580,63313,52036,53309,5208,5194,772,768,2294,2588,162,161,1108,1293,23496,23257,38084,40056
Bexar,10,124006,60539,63467,51566,53754,5166,5208,722,843,2089,2497,126,139,870,1026,24944,24731,35595,38736
Bexar,11,112882,55184,57698,47096,49059,4842,4927,756,743,1655,2005,115,130,720,834,24338,24193,30846,33505
Bexar,12,111819,53753,58066,46216,49682,4698,4879,691,784,1397,1850,123,137,628,734,25347,26378,28406,31688
Bexar,13,97488,45368,52120,39251,44943,3837,4191,596,529,1118,1799,83,87,483,571,22062,25145,23306,26975
Bexar,14,81429,37039,44390,32561,38897,2817,3123,399,415,889,1568,53,61,320,326,18915,21683,18124,22707
Bexar,15,61683,27789,33894,24900,30110,1704,2098,270,300,703,1100,41,39,171,247,15026,17369,12763,16525
Bexar,16,40737,17611,23126,15915,20527,1035,1533,156,157,388,731,13,20,104,158,9719,12069,7892,11057
Bexar,17,27654,11136,16518,10072,14875,680,1009,83,126,259,401,5,17,37,90,6169,8571,4967,7947
Bexar,18,28019,9990,18029,9105,16331,538,1051,97,165,206,404,2,9,42,69,5916,10077,4074,7952
Blanco,5,539,289,250,257,235,6,3,11,3,9,2,1,0,5,7,191,192,98,58
Blanco,6,499,260,239,241,222,6,6,6,7,0,0,0,0,7,4,203,189,57,50
Blanco,7,519,251,268,234,251,4,2,2,3,3,4,0,0,8,8,184,189,67,79
Blanco,8,575,323,252,281,239,28,4,4,4,3,1,0,0,7,4,225,169,98,83
Blanco,9,624,318,306,286,295,13,2,8,3,5,3,1,1,5,2,228,239,90,67
Blanco,10,713,343,370,324,363,5,1,10,2,1,3,0,0,3,1,252,297,91,73
Blanco,11,800,376,424,349,395,12,6,10,7,1,15,1,0,3,1,306,338,70,86
Blanco,12,1059,524,535,497,490,18,6,6,5,0,29,0,1,3,4,452,465,72,70
Blanco,13,1096,542,554,523,529,6,6,5,3,0,7,0,0,8,9,483,496,59,58
Blanco,14,966,443,523,430,509,6,5,2,1,3,2,0,2,2,4,395,480,48,43
Blanco,15,813,405,408,389,402,1,1,7,1,0,2,0,0,8,2,378,379,27,29
Blanco,16,531,261,270,254,265,1,1,3,1,0,1,1,1,2,1,247,256,14,14
Blanco,17,309,143,166,140,164,0,0,3,0,0,0,0,0,0,2,129,157,14,9
Blanco,18,249,110,139,108,136,0,0,1,1,0,0,0,2,1,0,103,130,7,9
Borden,5,29,16,13,16,12,0,0,0,0,0,0,0,0,0,1,9,12,7,1
Borden,6,20,11,9,9,9,0,0,0,0,0,0,0,0,2,0,9,7,2,2
Borden,7,27,13,14,11,14,2,0,0,0,0,0,0,0,0,0,13,12,0,2
Borden,8,34,18,16,18,16,0,0,0,0,0,0,0,0,0,0,11,13,7,3
Borden,9,33,15,18,15,18,0,0,0,0,0,0,0,0,0,0,11,16,4,2
Borden,10,65,39,26,37,24,0,0,0,1,0,0,0,0,2,1,34,21,5,5
Borden,11,45,19,26,19,24,0,0,0,1,0,0,0,0,0,1,15,17,4,9
Borden,12,46,28,18,23,15,2,0,0,1,0,1,0,0,3,1,19,15,9,3
Borden,13,44,19,25,19,24,0,0,0,0,0,0,0,0,0,1,13,22,6,3
Borden,14,43,22,21,22,21,0,0,0,0,0,0,0,0,0,0,20,18,2,3
Borden,15,35,19,16,19,16,0,0,0,0,0,0,0,0,0,0,18,15,1,1
Borden,16,25,16,9,16,9,0,0,0,0,0,0,0,0,0,0,15,9,1,0
Borden,17,32,17,15,17,15,0,0,0,0,0,0,0,0,0,0,17,15,0,0
Borden,18,30,11,19,10,19,0,0,0,0,0,0,0,0,1,0,9,17,2,2
Bosque,5,866,466,400,426,369,17,10,8,7,4,3,0,1,11,10,330,277,136,123
Bosque,6,959,457,502,417,471,12,11,10,8,7,4,2,0,9,8,318,376,139,126
Bosque,7,850,400,450,387,421,6,12,3,6,2,4,0,1,2,6,306,337,94,113
Bosque,8,1024,513,511,474,486,16,10,7,1,3,5,1,1,12,8,387,374,126,137
Bosque,9,903,433,470,415,447,12,12,2,3,1,4,0,0,3,4,327,353,106,117
Bosque,10,1026,490,536,464,517,18,6,6,4,0,5,0,0,2,4,401,431,89,105
Bosque,11,1166,577,589,551,566,7,10,5,4,7,4,0,0,7,5,473,491,104,98
Bosque,12,1365,660,705,630,685,17,8,3,2,2,5,0,0,8,5,576,632,84,73
Bosque,13,1465,715,750,685,715,15,9,10,10,0,5,0,0,5,11,659,691,56,59
Bosque,14,1337,687,650,656,630,10,10,9,3,5,3,0,1,7,3,636,609,51,41
Bosque,15,1245,598,647,579,630,6,7,3,2,1,2,0,0,9,6,558,603,40,44
Bosque,16,902,435,467,422,457,3,6,4,0,1,0,1,0,4,4,411,447,24,20
Bosque,17,544,233,311,220,302,8,4,0,0,2,3,0,1,3,1,224,297,9,14
Bosque,18,569,247,322,236,317,1,0,6,2,0,2,0,0,4,1,237,309,10,13
Bowie,5,5821,3153,2668,1999,1678,978,837,39,36,46,20,6,3,85,94,2721,2429,432,239
Bowie,6,6734,3667,3067,2427,1942,1079,988,51,28,38,37,9,1,63,71,3151,2853,516,214
Bowie,7,6089,3247,2842,2205,1934,902,769,39,30,48,58,3,3,50,48,2727,2643,520,199
Bowie,8,6240,3186,3054,2225,2027,834,860,40,26,36,97,4,1,47,43,2774,2864,412,190
Bowie,9,5722,3005,2717,2094,1906,811,683,24,36,35,57,3,3,38,32,2667,2553,338,164
Bowie,10,5811,3048,2763,2234,1964,680,686,40,29,63,48,3,4,28,32,2778,2646,270,117
Bowie,11,5657,2821,2836,2096,2019,619,709,30,37,29,35,6,0,41,36,2609,2725,212,111
Bowie,12,6085,2975,3110,2182,2249,684,742,32,39,35,50,4,3,38,27,2848,3009,127,101
Bowie,13,5644,2713,2931,1994,2180,640,662,25,24,17,30,1,2,36,33,2618,2868,95,63
Bowie,14,4866,2272,2594,1745,1952,450,556,31,32,12,26,0,1,34,27,2232,2541,40,53
Bowie,15,4066,1838,2228,1484,1758,312,418,23,17,7,11,0,2,12,22,1780,2187,58,41
Bowie,16,2827,1239,1588,1029,1302,180,249,8,13,4,9,1,0,17,15,1225,1566,14,22
Bowie,17,1731,707,1024,604,842,82,161,9,7,1,4,0,0,11,10,694,1011,13,13
Bowie,18,2035,650,1385,542,1133,96,226,5,7,0,7,0,0,7,12,643,1364,7,21
Brazoria,5,21118,11018,10100,8405,7592,1685,1504,104,117,551,628,13,14,260,245,6660,6072,4358,4028
Brazoria,6,24820,12751,12069,9693,9156,1989,1782,136,117,693,750,14,14,226,250,8186,7829,4565,4240
Brazoria,7,27165,13847,13318,10406,9747,2243,2020,123,104,890,1215,15,13,170,219,9017,8990,4830,4328
Brazoria,8,28464,14468,13996,10586,10186,2557,2290,128,116,988,1206,12,19,197,179,9567,9371,4901,4625
Brazoria,9,25853,13226,12627,9423,8903,2335,2144,94,85,1164,1295,26,9,184,191,8863,8714,4363,3913
Brazoria,10,25658,13220,12438,9457,8995,2377,2016,117,93,1126,1166,13,11,130,157,9505,9002,3715,3436
Brazoria,11,23192,11943,11249,8914,8426,2008,1706,93,86,787,877,11,14,130,140,8819,8346,3124,2903
Brazoria,12,22602,11253,11349,8835,8806,1609,1647,92,111,608,667,11,5,98,113,8756,9005,2497,2344
Brazoria,13,20059,9956,10103,7989,7934,1268,1410,102,90,510,584,8,4,79,81,7901,8181,2055,1922
Brazoria,14,15504,7576,7928,6132,6106,907,1110,66,62,419,578,6,2,46,70,6157,6537,1419,1391
Brazoria,15,11551,5473,6078,4500,4868,561,662,42,33,317,478,2,2,51,35,4598,5070,875,1008
Brazoria,16,7480,3361,4119,2851,3448,278,348,27,31,187,263,2,1,16,28,2857,3550,504,569
Brazoria,17,4767,2115,2652,1856,2290,122,195,20,16,100,137,0,0,17,14,1791,2285,324,367
Brazoria,18,4378,1573,2805,1394,2339,95,257,17,25,51,164,0,1,16,19,1364,2426,209,379
Brazos,5,43685,23443,20242,19337,16863,1505,1418,105,137,2000,1323,10,13,486,488,18692,16013,4751,4229
Brazos,6,20401,10684,9717,8176,7449,1345,1201,113,67,837,766,17,11,196,223,7846,7015,2838,2702
Brazos,7,15647,7962,7685,6063,5827,925,1048,74,50,776,638,11,15,113,107,5679,5542,2283,2143
Brazos,8,14158,7264,6894,5500,5353,827,833,60,47,733,548,33,8,111,105,5114,4850,2150,2044
Brazos,9,11164,5676,5488,4379,4176,620,733,43,48,531,439,17,5,86,87,3967,3816,1709,1672
Brazos,10,10629,5164,5465,4039,4226,586,737,33,34,426,378,7,9,73,81,3775,4070,1389,1395
Brazos,11,9744,4806,4938,3861,3888,609,734,39,33,247,235,5,5,45,43,3576,3768,1230,1170
Brazos,12,9760,4695,5065,3870,4080,575,698,37,35,174,189,6,9,33,54,3756,4179,939,886
Brazos,13,9140,4367,4773,3655,3967,489,580,32,29,160,160,4,7,27,30,3604,4039,763,734
Brazos,14,7008,3388,3620,2908,3091,311,396,23,17,126,104,1,0,19,12,2887,3134,501,486
Brazos,15,5243,2373,2870,2069,2526,199,246,16,14,72,60,2,6,15,18,2069,2450,304,420
Brazos,16,3598,1586,2012,1422,1746,101,177,4,8,49,65,0,1,10,15,1420,1820,166,192
Brazos,17,2427,1026,1401,930,1226,67,138,6,8,17,21,0,0,6,8,903,1270,123,131
Brazos,18,2438,937,1501,847,1341,63,127,6,9,13,17,0,0,8,7,857,1361,80,140
Brewster,5,485,234,251,212,225,7,8,6,4,5,4,1,0,3,10,83,100,151,151
Brewster,6,599,307,292,281,271,8,5,6,2,7,7,0,2,5,5,142,128,165,164
Brewster,7,623,328,295,297,274,10,3,5,5,8,7,1,1,7,5,167,167,161,128
Brewster,8,636,331,305,314,271,10,8,2,5,4,8,0,1,1,12,167,155,164,150
Brewster,9,530,253,277,234,250,0,10,3,6,4,9,1,0,11,2,113,146,140,131
Brewster,10,492,256,236,235,218,4,1,7,6,5,6,0,0,5,5,142,121,114,115
Brewster,11,534,257,277,241,254,2,2,9,6,3,5,0,0,2,10,132,140,125,137
Brewster,12,613,318,295,303,278,4,0,5,9,2,2,0,0,4,6,180,172,138,123
Brewster,13,681,325,356,304,342,5,2,10,4,1,2,1,0,4,6,219,259,106,97
Brewster,14,706,345,361,327,344,8,0,5,8,0,3,1,0,4,6,244,268,101,93
Brewster,15,569,322,247,312,237,2,0,3,2,1,2,0,0,4,6,252,179,70,68
Brewster,16,394,205,189,201,184,0,0,0,2,1,0,1,0,2,3,153,129,52,60
Brewster,17,250,136,114,129,112,3,0,2,2,0,0,0,0,2,0,95,70,41,44
Brewster,18,232,68,164,66,159,0,1,1,0,0,0,0,1,1,3,47,102,21,62
Briscoe,5,76,42,34,39,28,1,1,0,1,0,0,0,0,2,4,31,28,11,6
Briscoe,6,68,31,37,24,35,5,2,0,0,0,0,0,0,2,0,20,20,11,17
Briscoe,7,90,50,40,45,36,5,2,0,1,0,0,0,0,0,1,34,27,16,13
Briscoe,8,81,36,45,36,40,0,2,0,0,0,1,0,0,0,2,22,34,14,11
Briscoe,9,96,47,49,42,47,2,2,1,0,0,0,0,0,2,0,28,26,19,23
Briscoe,10,84,41,43,39,42,2,1,0,0,0,0,0,0,0,0,32,29,9,14
Briscoe,11,96,42,54,42,49,0,1,0,3,0,0,0,0,0,1,34,41,8,13
Briscoe,12,110,60,50,59,49,0,0,0,1,0,0,0,0,1,0,44,34,16,16
Briscoe,13,89,35,54,32,52,3,1,0,0,0,0,0,0,0,1,30,48,5,6
Briscoe,14,103,62,41,61,38,0,1,1,0,0,0,0,0,0,2,55,40,7,1
Briscoe,15,109,53,56,51,53,1,3,0,0,0,0,0,0,1,0,50,49,3,7
Briscoe,16,72,34,38,33,36,1,1,0,0,0,0,0,0,0,1,32,32,2,6
Briscoe,17,61,30,31,30,30,0,1,0,0,0,0,0,0,0,0,27,27,3,4
Briscoe,18,50,23,27,22,25,0,1,0,0,0,0,0,0,1,1,18,26,5,1
Brooks,5,450,269,181,261,171,2,2,2,5,3,2,0,0,1,1,16,11,253,170
Brooks,6,502,282,220,271,218,5,0,0,2,6,0,0,0,0,0,17,14,265,206
Brooks,7,404,237,167,227,158,4,1,4,3,2,3,0,0,0,2,9,13,228,154
Brooks,8,424,218,206,208,193,5,4,3,2,1,7,0,0,1,0,16,22,202,184
Brooks,9,357,192,165,180,161,0,1,2,2,9,1,0,0,1,0,21,9,171,156
Brooks,10,319,144,175,139,170,1,0,3,3,1,0,0,0,0,2,23,18,121,157
Brooks,11,361,178,183,175,175,1,6,1,2,1,0,0,0,0,0,18,9,160,174
Brooks,12,418,205,213,201,208,3,4,1,1,0,0,0,0,0,0,14,19,191,194
Brooks,13,402,200,202,195,194,3,2,1,1,0,5,0,0,1,0,24,22,176,180
Brooks,14,366,155,211,152,209,0,0,2,0,1,0,0,1,0,1,13,21,142,190
Brooks,15,329,156,173,153,173,1,0,1,0,0,0,1,0,0,0,19,16,137,157
Brooks,16,252,114,138,114,135,0,0,0,1,0,1,0,0,0,1,21,5,93,133
Brooks,17,193,78,115,78,113,0,1,0,0,0,0,0,1,0,0,18,15,60,100
Brooks,18,145,47,98,45,96,2,2,0,0,0,0,0,0,0,0,7,16,40,82
Brown,5,2249,1174,1075,1059,977,69,44,5,10,17,9,1,3,23,32,817,759,357,316
Brown,6,2270,1182,1088,1030,1009,87,39,13,11,32,10,1,2,19,17,850,781,332,307
Brown,7,2249,1110,1139,995,1060,87,41,11,12,3,10,0,1,14,15,736,801,374,338
Brown,8,2289,1144,1145,1052,1067,59,34,14,16,8,16,0,0,11,12,857,837,287,308
Brown,9,2066,1034,1032,942,977,58,22,6,9,17,16,0,0,11,8,780,762,254,270
Brown,10,2323,1163,1160,1079,1094,47,36,13,7,13,10,1,4,10,9,909,899,254,261
Brown,11,2315,1169,1146,1099,1082,44,30,7,11,7,6,2,0,10,17,923,910,246,236
Brown,12,2703,1337,1366,1241,1284,60,41,16,21,6,6,1,0,13,14,1106,1166,231,200
Brown,13,2497,1172,1325,1096,1251,48,39,14,12,2,10,0,1,12,12,1016,1157,156,168
Brown,14,2301,1107,1194,1062,1151,22,18,9,5,5,7,1,1,8,12,972,1061,135,133
Brown,15,1908,938,970,893,928,13,16,8,4,4,6,1,1,19,15,858,890,80,80
Brown,16,1461,664,797,642,770,8,11,2,5,2,6,0,0,10,5,605,741,59,56
Brown,17,921,407,514,392,497,5,9,4,3,0,1,0,0,6,4,381,479,26,35
Brown,18,944,363,581,343,563,5,7,3,4,3,2,1,0,8,5,324,557,39,24
Burleson,5,928,436,492,351,386,71,84,4,8,1,4,0,1,9,9,302,347,134,145
Burleson,6,1091,516,575,432,456,60,102,9,6,3,5,1,0,11,6,385,437,131,138
Burleson,7,1011,505,506,425,422,65,68,4,4,7,1,0,0,4,11,373,397,132,109
Burleson,8,1013,480,533,402,448,63,74,7,7,3,0,0,1,5,3,367,384,113,149
Burleson,9,913,442,471,375,394,57,63,4,7,1,2,0,0,5,5,337,339,105,132
Burleson,10,1053,517,536,440,459,65,67,7,4,1,3,0,0,4,3,413,431,104,105
Burleson,11,1255,643,612,539,528,85,69,14,8,3,1,0,0,2,6,509,510,134,102
Burleson,12,1431,718,713,609,624,86,66,13,10,4,2,1,0,5,11,596,623,122,90
Burleson,13,1461,680,781,614,688,55,83,9,3,1,2,0,1,1,4,612,717,68,64
Burleson,14,1212,610,602,522,513,80,75,1,1,1,6,0,0,6,7,558,539,52,63
Burleson,15,968,495,473,441,408,46,50,4,4,0,2,0,0,4,9,445,432,50,41
Burleson,16,575,296,279,256,251,29,24,3,1,1,0,0,0,7,3,269,257,27,22
Burleson,17,451,198,253,176,217,20,33,2,2,0,0,0,0,0,1,182,234,16,19
Burleson,18,518,215,303,192,265,21,35,1,0,1,0,0,1,0,2,189,283,26,20
Burnet,5,2506,1274,1232,1149,1153,65,27,18,14,11,10,0,0,31,28,866,808,408,424
Burnet,6,2627,1279,1348,1158,1224,72,60,19,21,13,14,1,0,16,29,884,938,395,410
Burnet,7,2477,1250,1227,1138,1150,58,32,25,13,10,8,3,2,16,22,857,883,393,344
Burnet,8,2629,1264,1365,1192,1283,27,37,23,20,15,14,1,2,6,9,879,1010,385,355
Burnet,9,2552,1218,1334,1127,1259,37,25,17,11,19,25,2,0,16,14,901,978,317,356
Burnet,10,2704,1346,1358,1280,1271,21,37,15,13,9,11,0,1,21,25,1026,1082,320,276
Burnet,11,2836,1375,1461,1304,1400,21,24,32,16,10,12,0,0,8,9,1073,1179,302,282
Burnet,12,3604,1747,1857,1676,1781,24,25,16,18,10,11,3,0,18,22,1478,1585,269,272
Burnet,13,3673,1729,1944,1652,1877,29,10,18,28,14,16,0,2,16,11,1524,1746,205,198
Burnet,14,3500,1690,1810,1633,1749,21,11,11,17,10,15,3,0,12,18,1539,1671,151,139
Burnet,15,2873,1401,1472,1362,1417,9,21,11,7,4,14,1,2,14,11,1296,1377,105,95
Burnet,16,1874,882,992,868,968,2,10,8,7,3,1,0,0,1,6,849,935,33,57
Burnet,17,1253,559,694,550,670,2,8,2,4,2,5,1,0,2,7,532,662,27,32
Burnet,18,1119,462,657,451,636,1,3,4,4,0,5,0,0,6,9,430,634,32,23
Caldwell,5,3401,1931,1470,1589,1277,209,99,28,24,72,49,0,1,33,20,904,589,1027,881
Caldwell,6,2949,1519,1430,1346,1243,105,109,27,27,9,20,5,1,27,30,629,609,890,821
Caldwell,7,2880,1420,1460,1255,1292,107,104,23,18,10,11,2,2,23,33,617,634,803,826
Caldwell,8,2795,1416,1379,1263,1225,99,98,19,25,5,10,2,0,28,21,648,630,768,749
Caldwell,9,2573,1258,1315,1128,1184,82,83,23,20,10,5,0,1,15,22,549,582,709,733
Caldwell,10,2705,1343,1362,1222,1235,77,77,22,27,3,11,1,1,18,11,651,658,692,704
Caldwell,11,2625,1322,1303,1203,1189,68,77,23,17,9,9,2,1,17,10,655,643,667,660
Caldwell,12,2726,1369,1357,1226,1209,103,94,18,20,5,13,0,1,17,20,826,814,543,543
Caldwell,13,2590,1271,1319,1142,1184,80,87,28,20,7,8,0,1,14,19,802,827,469,492
Caldwell,14,2125,1029,1096,947,1004,59,61,9,15,5,11,0,0,9,5,688,721,341,375
Caldwell,15,1573,745,828,683,771,45,34,12,8,0,3,0,1,5,11,484,535,261,293
Caldwell,16,1073,462,611,425,562,27,36,4,3,3,5,0,0,3,5,318,414,144,197
Caldwell,17,722,313,409,291,375,15,24,3,2,3,2,0,1,1,5,201,274,112,135
Caldwell,18,719,236,483,214,439,14,37,5,3,1,2,0,0,2,2,185,373,51,110
Calhoun,5,1280,675,605,595,540,23,21,5,6,41,26,1,1,10,11,242,222,433,383
Calhoun,6,1431,791,640,668,561,20,23,7,4,79,47,0,0,17,5,358,290,433,350
Calhoun,7,1275,690,585,597,514,29,15,7,7,46,40,0,1,11,8,300,238,390,347
Calhoun,8,1323,655,668,581,599,19,16,8,5,39,34,0,0,8,14,266,308,389,360
Calhoun,9,1153,589,564,522,489,25,25,6,6,34,38,0,0,2,6,290,266,299,298
Calhoun,10,1227,621,606,554,553,26,13,3,2,34,34,1,2,3,2,292,304,329,302
Calhoun,11,1315,679,636,615,576,18,19,3,1,38,37,0,0,5,3,375,342,304,294
Calhoun,12,1453,762,691,661,622,26,20,9,3,49,41,0,0,17,5,471,419,291,272
Calhoun,13,1373,668,705,584,648,22,22,7,3,42,25,1,0,12,7,448,462,220,243
Calhoun,14,1249,644,605,569,547,18,16,4,3,50,34,0,0,3,5,454,408,190,197
Calhoun,15,1011,529,482,469,462,10,10,10,3,33,5,0,0,7,2,409,327,120,155
Calhoun,16,692,338,354,322,335,4,11,1,1,9,6,1,0,1,1,251,271,87,83
Calhoun,17,489,213,276,192,260,11,7,2,3,7,5,0,0,1,1,169,196,44,80
Calhoun,18,454,178,276,169,254,0,8,2,0,3,9,0,1,4,4,143,212,35,64
Callahan,5,636,315,321,297,290,6,11,4,5,3,2,0,0,5,13,257,267,58,54
Callahan,6,768,388,380,365,359,12,6,2,2,2,8,0,1,7,4,331,334,57,46
Callahan,7,801,393,408,381,391,6,1,2,3,1,5,0,2,3,6,335,365,58,43
Callahan,8,833,421,412,398,390,10,10,3,1,1,4,3,0,6,7,363,360,58,52
Callahan,9,817,393,424,377,401,7,5,1,1,1,7,0,0,7,10,347,384,46,40
Callahan,10,820,380,440,365,424,10,2,2,8,1,1,0,0,2,5,353,387,27,53
Callahan,11,862,446,416,424,394,9,3,5,7,5,7,0,0,3,5,414,383,32,33
Callahan,12,1108,547,561,521,536,8,7,7,4,3,4,0,0,8,10,493,516,54,45
Callahan,13,1069,505,564,480,540,6,7,2,7,6,3,0,1,11,6,475,541,30,23
Callahan,14,913,444,469,424,454,11,4,1,4,1,4,0,0,7,3,423,455,21,14
Callahan,15,739,382,357,371,348,3,1,2,4,3,1,0,0,3,3,372,344,10,13
Callahan,16,502,241,261,233,255,2,0,1,4,0,2,0,0,5,0,231,252,10,9
Callahan,17,376,178,198,175,189,0,2,2,2,0,2,0,0,1,3,168,188,10,10
Callahan,18,340,134,206,127,199,1,5,3,0,0,1,0,0,3,1,125,200,9,6
Cameron,5,30959,15931,15028,15461,14664,126,103,115,108,140,68,23,7,66,78,844,744,15087,14284
Cameron,6,28148,14315,13833,13838,13423,147,101,95,132,148,104,14,9,73,64,1003,883,13312,12950
Cameron,7,24209,12045,12164,11560,11719,151,95,101,126,139,138,11,5,83,81,1079,985,10966,11179
Cameron,8,25179,12313,12866,11863,12536,149,92,102,70,115,100,13,15,71,53,1045,893,11268,11973
Cameron,9,26120,12681,13439,12283,13084,132,115,93,80,101,103,13,10,59,47,1045,934,11636,12505
Cameron,10,25188,11676,13512,11345,13149,115,76,76,106,95,124,6,7,39,50,1106,1049,10570,12463
Cameron,11,22234,10269,11965,9930,11625,106,80,71,86,110,119,7,14,45,41,1148,1174,9121,10791
Cameron,12,21332,9824,11508,9499,11218,96,52,74,71,109,117,9,9,37,41,1451,1461,8373,10047
Cameron,13,19740,8900,10840,8619,10552,72,55,52,66,118,124,6,8,33,35,1617,1711,7283,9129
Cameron,14,17514,8065,9449,7815,9224,62,34,68,55,84,113,7,4,29,19,1870,1791,6195,7658
Cameron,15,14544,6650,7894,6506,7744,38,26,31,28,55,52,1,8,19,36,1797,1848,4853,6046
Cameron,16,10262,4525,5737,4434,5619,20,18,28,29,30,38,3,4,10,29,1552,1567,2973,4170
Cameron,17,7478,3175,4303,3091,4220,18,19,27,17,20,28,1,3,18,16,1159,1158,2016,3145
Cameron,18,7222,2800,4422,2724,4343,15,11,24,21,16,33,0,3,21,11,1065,1206,1735,3216
Camp,5,847,449,398,319,320,78,62,8,2,29,3,3,1,12,10,288,241,161,157
Camp,6,768,364,404,263,310,57,67,8,3,14,3,0,1,22,20,241,268,123,136
Camp,7,689,334,355,261,279,56,61,4,4,4,1,0,0,9,10,251,250,83,105
Camp,8,712,323,389,248,305,61,71,3,3,3,1,0,3,8,6,244,292,79,97
Camp,9,640,319,321,253,256,58,54,4,4,0,5,0,0,4,2,217,239,102,82
Camp,10,721,315,406,260,320,42,76,4,3,2,2,1,0,6,5,235,320,80,86
Camp,11,779,363,416,288,322,60,80,8,4,4,4,0,2,3,4,275,331,88,85
Camp,12,826,411,415,339,319,49,83,7,4,4,2,1,1,11,6,317,357,94,58
Camp,13,827,385,442,309,343,66,88,4,4,1,4,0,2,5,1,340,415,45,27
Camp,14,824,413,411,335,333,69,73,4,0,0,1,0,0,5,4,378,389,35,22
Camp,15,602,296,306,240,261,51,40,2,1,1,2,0,0,2,2,270,288,26,18
Camp,16,434,210,224,185,177,20,44,1,1,0,0,1,0,3,2,202,212,8,12
Camp,17,321,153,168,132,140,21,26,0,1,0,0,0,1,0,0,147,166,6,2
Camp,18,234,91,143,81,107,8,33,0,0,0,1,0,0,2,2,83,135,8,8
Carson,5,308,147,161,136,148,3,5,2,3,1,1,0,0,5,4,131,133,16,28
Carson,6,320,162,158,146,144,1,3,4,0,1,2,0,0,10,9,138,145,24,13
Carson,7,335,170,165,161,154,1,1,4,3,0,2,0,0,4,5,141,149,29,16
Carson,8,377,191,186,187,179,1,1,3,4,0,1,0,0,0,1,172,159,19,27
Carson,9,357,173,184,163,177,2,1,4,2,2,1,0,0,2,3,164,166,9,18
Carson,10,315,160,155,153,149,0,1,4,2,3,2,0,0,0,1,142,137,18,18
Carson,11,371,184,187,182,177,0,0,1,4,0,3,0,0,1,3,165,173,19,14
Carson,12,420,218,202,203,197,7,1,5,2,0,1,0,0,3,1,197,178,21,24
Carson,13,448,225,223,212,213,3,0,7,4,0,4,0,1,3,1,207,209,18,14
Carson,14,378,191,187,181,181,0,1,6,2,1,3,1,0,2,0,183,176,8,11
Carson,15,296,147,149,140,147,0,0,5,2,0,0,1,0,1,0,141,143,6,6
Carson,16,225,108,117,108,112,0,1,0,4,0,0,0,0,0,0,101,111,7,6
Carson,17,160,77,83,73,80,0,0,0,1,0,0,0,0,4,2,75,78,2,5
Carson,18,128,42,86,40,84,0,0,1,0,0,0,0,0,1,2,38,81,4,5
Cass,5,1547,801,746,615,565,161,161,4,5,3,3,1,0,17,12,738,683,63,63
Cass,6,1572,767,805,588,617,154,168,8,8,4,5,0,1,13,6,724,760,43,45
Cass,7,1485,679,806,541,655,113,135,5,4,4,6,4,1,12,5,653,736,26,70
Cass,8,1654,782,872,646,711,118,135,5,7,7,9,1,1,5,9,731,816,51,56
Cass,9,1611,749,862,610,663,123,178,4,5,4,4,1,0,7,12,712,829,37,33
Cass,10,1874,898,976,738,819,136,131,9,13,6,5,0,0,9,8,857,929,41,47
Cass,11,1949,957,992,771,796,160,183,11,6,6,4,0,0,9,3,923,962,34,30
Cass,12,2119,1003,1116,830,892,151,204,7,6,2,3,0,0,13,11,981,1091,22,25
Cass,13,2177,1029,1148,865,935,151,184,5,13,4,3,0,0,4,13,1002,1125,27,23
Cass,14,1927,943,984,788,817,146,156,3,5,3,1,1,0,2,5,937,972,6,12
Cass,15,1762,838,924,705,761,115,148,6,4,3,1,1,0,8,10,828,920,10,4
Cass,16,1366,632,734,540,622,80,101,2,4,3,3,0,1,7,3,629,728,3,6
Cass,17,828,344,484,292,400,46,77,2,4,0,0,0,0,4,3,337,478,7,6
Cass,18,817,295,522,245,435,47,81,0,1,0,4,0,0,3,1,290,519,5,3
Castro,5,548,273,275,246,248,12,11,9,5,2,8,0,0,4,3,52,63,221,212
Castro,6,440,210,230,197,218,5,6,6,1,1,2,0,0,1,3,69,61,141,169
Castro,7,419,206,213,186,196,11,5,5,7,1,4,0,0,3,1,54,47,152,166
Castro,8,451,237,214,225,201,5,4,2,5,3,2,0,0,2,2,70,68,167,146
Castro,9,411,216,195,197,180,11,2,2,7,5,3,0,0,1,3,58,65,158,130
Castro,10,388,214,174,199,163,6,3,5,2,2,1,0,0,2,5,68,61,146,113
Castro,11,367,191,176,176,168,5,3,4,3,0,0,0,0,6,2,74,78,117,98
Castro,12,476,250,226,242,219,6,3,1,4,0,0,0,0,1,0,120,106,130,120
Castro,13,499,269,230,255,213,7,9,6,6,0,2,0,0,1,0,115,111,154,119
Castro,14,356,181,175,170,164,9,7,2,2,0,1,0,0,0,1,88,82,93,93
Castro,15,264,135,129,133,125,2,1,0,2,0,0,0,0,0,1,77,73,58,56
Castro,16,221,105,116,101,116,0,0,2,0,1,0,0,0,1,0,70,62,35,54
Castro,17,193,88,105,86,103,1,0,0,1,0,0,0,0,1,1,59,77,29,28
Castro,18,166,66,100,62,94,2,2,1,2,0,0,0,0,1,2,50,76,16,24
Chambers,5,2528,1285,1243,1111,1076,126,110,20,15,11,16,1,2,16,24,887,852,398,391
Chambers,6,2741,1404,1337,1175,1192,171,104,23,11,10,8,3,3,22,19,998,956,406,381
Chambers,7,2893,1406,1487,1242,1332,110,94,19,14,22,31,2,0,11,16,987,1130,419,357
Chambers,8,3164,1654,1510,1462,1327,135,115,20,20,16,38,0,1,21,9,1147,1105,507,405
Chambers,9,2859,1407,1452,1249,1277,101,122,18,11,27,24,1,3,11,15,1019,1115,388,337
Chambers,10,2870,1429,1441,1248,1271,132,122,14,9,15,20,3,1,17,18,1132,1182,297,259
Chambers,11,2578,1323,1255,1151,1101,127,100,13,15,16,22,2,3,14,14,1088,1057,235,198
Chambers,12,2478,1286,1192,1151,1056,91,104,18,11,15,11,0,0,11,10,1120,1066,166,126
Chambers,13,2258,1161,1097,1003,970,108,91,17,12,22,15,2,0,9,9,1017,966,144,131
Chambers,14,1814,914,900,800,779,80,88,9,10,18,18,2,2,5,3,811,825,103,75
Chambers,15,1409,655,754,576,655,63,71,3,8,8,8,0,0,5,12,610,713,45,41
Chambers,16,808,377,431,344,375,28,49,1,3,2,2,0,0,2,2,348,411,29,20
Chambers,17,518,225,293,203,263,18,27,1,1,2,1,0,0,1,1,213,286,12,7
Chambers,18,456,173,283,156,244,13,33,3,3,0,1,0,0,1,2,160,277,13,6
Cherokee,5,3274,1826,1448,1355,1132,374,247,44,33,22,6,1,1,30,29,1223,970,603,478
Cherokee,6,3225,1688,1537,1294,1209,328,250,28,37,17,12,0,0,21,29,1211,1110,477,427
Cherokee,7,3008,1532,1476,1196,1207,279,218,28,26,10,5,2,0,17,20,1113,1110,419,366
Cherokee,8,2907,1463,1444,1169,1174,234,196,37,35,7,11,2,1,14,27,1067,1070,396,374
Cherokee,9,3099,1635,1464,1294,1221,250,195,46,20,10,9,0,0,35,19,1198,1110,437,354
Cherokee,10,3233,1731,1502,1357,1246,311,200,30,31,10,12,3,1,20,12,1308,1172,423,330
Cherokee,11,3120,1640,1480,1302,1197,288,221,27,27,6,15,0,1,17,19,1305,1220,335,260
Cherokee,12,3241,1603,1638,1301,1351,243,250,31,10,7,15,2,0,19,12,1350,1455,253,183
Cherokee,13,3173,1566,1607,1277,1329,234,235,27,16,6,12,1,1,21,14,1396,1485,170,122
Cherokee,14,2915,1397,1518,1173,1296,192,188,16,15,4,8,0,0,12,11,1277,1437,120,81
Cherokee,15,2400,1092,1308,974,1175,102,109,7,8,4,2,0,0,5,14,1022,1241,70,67
Cherokee,16,1717,820,897,758,795,50,86,4,6,1,3,0,1,7,6,771,859,49,38
Cherokee,17,1083,505,578,450,505,40,63,2,3,2,3,1,0,10,4,480,557,25,21
Cherokee,18,1059,374,685,332,601,34,77,1,4,2,1,0,0,5,2,356,652,18,33
Childress,5,787,625,162,453,147,160,11,4,1,4,0,0,0,4,3,328,97,297,65
Childress,6,884,721,163,521,147,193,6,3,5,2,0,0,0,2,5,395,124,326,39
Childress,7,590,437,153,320,144,112,6,0,2,2,1,0,0,3,0,268,112,169,41
Childress,8,512,337,175,289,167,41,4,3,0,2,2,0,1,2,1,190,131,147,44
Childress,9,409,242,167,203,150,34,9,2,2,1,3,0,0,2,3,176,112,66,55
Childress,10,343,197,146,177,135,14,7,4,1,0,2,0,0,2,1,133,99,64,47
Childress,11,327,166,161,143,148,19,9,3,2,0,0,0,0,1,2,127,126,39,35
Childress,12,380,186,194,168,176,14,8,2,2,1,4,0,0,1,4,152,165,34,29
Childress,13,366,191,175,167,163,18,8,3,1,3,1,0,0,0,2,160,145,31,30
Childress,14,316,156,160,142,154,9,3,1,0,1,1,0,0,3,2,130,140,26,20
Childress,15,283,115,168,109,156,4,3,1,3,1,3,0,0,0,3,93,144,22,24
Childress,16,230,111,119,105,107,2,9,2,3,1,0,0,0,1,0,98,110,13,9
Childress,17,142,54,88,48,84,2,3,0,0,0,0,0,0,4,1,49,84,5,4
Childress,18,153,57,96,55,91,1,4,0,0,0,0,0,0,1,1,48,87,9,9
Clay,5,494,273,221,260,201,2,5,6,5,0,0,0,0,5,10,251,191,22,30
Clay,6,502,239,263,224,250,2,4,4,5,2,1,0,0,7,3,221,245,18,18
Clay,7,468,246,222,233,212,5,2,2,2,1,0,0,0,5,6,227,201,19,21
Clay,8,596,289,307,277,291,0,1,5,6,2,3,0,0,5,6,267,271,22,36
Clay,9,584,293,291,283,267,4,4,2,7,1,8,0,0,3,5,256,267,37,24
Clay,10,615,294,321,278,286,5,1,2,3,0,20,0,0,9,11,272,296,22,25
Clay,11,699,352,347,340,334,1,1,3,10,2,0,0,0,6,2,339,332,13,15
Clay,12,914,451,463,438,441,3,5,4,8,1,1,0,0,5,8,432,437,19,26
Clay,13,885,446,439,420,431,8,1,8,4,0,0,1,0,9,3,437,431,9,8
Clay,14,760,373,387,357,377,4,1,6,3,1,1,0,0,5,5,361,372,12,15
Clay,15,615,308,307,298,294,2,0,3,7,0,1,0,0,5,5,301,296,7,11
Clay,16,432,204,228,196,223,2,0,3,1,0,0,0,0,3,4,198,219,6,9
Clay,17,290,145,145,141,137,0,0,0,1,0,2,0,0,4,5,141,140,4,5
Clay,18,288,122,166,117,161,0,0,3,2,0,1,0,0,2,2,118,164,4,2
Cochran,5,151,80,71,70,63,6,4,2,2,1,1,1,0,0,1,31,23,49,48
Cochran,6,196,107,89,90,85,6,0,6,3,1,1,0,0,4,0,48,26,59,63
Cochran,7,190,87,103,81,93,4,5,1,5,0,0,0,0,1,0,20,36,67,67
Cochran,8,163,93,70,88,64,5,4,0,1,0,0,0,0,0,1,36,26,57,44
Cochran,9,135,65,70,63,66,2,1,0,0,0,0,0,2,0,1,20,20,45,50
Cochran,10,161,80,81,72,71,3,3,2,5,1,1,1,0,1,1,27,37,53,44
Cochran,11,171,92,79,83,67,4,6,5,5,0,0,0,0,0,1,40,45,52,34
Cochran,12,197,99,98,89,87,4,7,4,2,1,1,0,0,1,1,51,62,48,36
Cochran,13,166,76,90,70,82,4,4,2,3,0,0,0,1,0,0,51,49,25,41
Cochran,14,130,58,72,52,63,2,3,3,4,0,0,0,0,1,2,30,41,28,31
Cochran,15,105,59,46,52,44,2,1,3,1,0,0,1,0,1,0,27,25,32,21
Cochran,16,83,39,44,35,41,2,2,0,1,0,0,0,0,2,0,25,22,14,22
Cochran,17,85,37,48,33,43,2,2,1,3,1,0,0,0,0,0,24,32,13,16
Cochran,18,52,22,30,20,25,1,4,1,1,0,0,0,0,0,0,16,26,6,4
Coke,5,151,73,78,64,71,0,1,5,2,0,0,0,0,4,4,46,54,27,24
Coke,6,178,97,81,85,74,5,0,5,3,0,0,0,0,2,4,66,62,31,19
Coke,7,170,96,74,88,71,0,0,5,1,2,2,0,0,1,0,65,57,31,17
Coke,8,169,75,94,73,88,2,2,0,2,0,0,0,0,0,2,49,70,26,24
Coke,9,146,75,71,68,68,3,0,2,2,0,1,0,0,2,0,58,58,17,13
Coke,10,157,69,88,65,87,1,0,2,0,0,0,0,0,1,1,50,65,19,23
Coke,11,208,98,110,95,105,0,0,3,4,0,0,0,0,0,1,73,85,25,25
Coke,12,262,136,126,130,123,0,1,4,2,0,0,1,0,1,0,112,99,24,27
Coke,13,217,112,105,106,102,1,0,4,3,0,0,0,0,1,0,98,91,14,14
Coke,14,268,132,136,127,132,3,2,1,1,0,0,0,0,1,1,116,122,16,14
Coke,15,217,100,117,94,109,1,0,1,4,0,0,0,0,4,4,92,106,8,11
Coke,16,188,94,94,93,89,0,0,1,4,0,0,0,0,0,1,87,85,7,9
Coke,17,137,72,65,70,64,0,0,1,1,0,0,0,0,1,0,63,61,9,4
Coke,18,104,42,62,41,60,0,0,1,1,0,0,0,0,0,1,38,61,4,1
Coleman,5,376,221,155,191,139,13,6,9,7,2,0,0,0,6,3,164,110,57,45
Coleman,6,392,186,206,167,184,9,7,6,6,1,4,0,0,3,5,147,159,39,47
Coleman,7,379,192,187,174,162,8,8,0,1,2,11,2,0,6,5,148,139,44,48
Coleman,8,419,211,208,198,191,9,5,3,3,0,7,0,0,1,2,153,168,58,40
Coleman,9,449,218,231,207,218,7,7,0,2,1,1,0,0,3,3,180,179,38,52
Coleman,10,471,233,238,216,226,10,6,2,4,1,0,0,0,4,2,188,194,45,44
Coleman,11,497,275,222,256,204,11,7,4,2,3,1,0,0,1,8,226,193,49,29
Coleman,12,695,337,358,322,327,7,11,4,11,1,0,0,0,3,9,298,317,39,41
Coleman,13,664,348,316,320,298,9,9,11,3,1,2,0,0,7,4,320,290,28,26
Coleman,14,627,281,346,265,331,10,6,2,2,0,1,0,0,4,6,254,319,27,27
Coleman,15,575,304,271,285,259,7,5,4,3,2,2,1,0,5,2,268,231,36,40
Coleman,16,363,187,176,183,169,2,3,1,3,0,1,0,0,1,0,169,154,18,22
Coleman,17,296,142,154,136,148,1,3,1,2,0,1,0,0,4,0,132,142,10,12
Coleman,18,217,90,127,88,119,1,4,1,1,0,2,0,0,0,1,83,118,7,9
Collin,5,57698,29304,28394,20555,19319,3652,3588,299,262,3731,4121,18,37,1049,1067,23108,22711,6196,5683
Collin,6,59995,30038,29957,20453,19886,3680,3996,260,282,4819,4933,41,30,785,830,24401,24625,5637,5332
Collin,7,68329,32899,35430,21776,22450,3561,4308,245,235,6572,7496,53,75,692,866,26760,29809,6139,5621
Collin,8,78744,37989,40755,24465,25479,4128,5309,313,251,8362,8862,47,58,674,796,31762,34600,6227,6155
Collin,9,80428,39150,41278,25756,26510,4210,5278,303,281,8226,8384,40,33,615,792,32830,34535,6320,6743
Collin,10,81665,40844,40821,28417,28315,4111,4679,285,230,7388,6882,29,43,614,672,35203,35164,5641,5657
Collin,11,69621,34758,34863,25795,25768,3164,3713,212,247,5023,4509,37,26,527,600,30450,30537,4308,4326
Collin,12,62881,31608,31273,24762,24098,2746,2993,161,205,3447,3515,26,34,466,428,28475,28066,3133,3207
Collin,13,48827,23468,25359,18638,19872,1805,2135,153,143,2523,2915,22,17,327,277,21407,23257,2061,2102
Collin,14,38327,17201,21126,13927,16505,1077,1755,80,94,1902,2574,10,22,205,176,15929,19610,1272,1516
Collin,15,30518,13811,16707,11475,13651,723,1063,63,81,1416,1764,6,3,128,145,13094,15644,717,1063
Collin,16,19709,8716,10993,7296,9123,303,565,46,44,976,1187,3,6,92,68,8238,10343,478,650
Collin,17,11441,4868,6573,4100,5595,144,297,19,27,573,604,1,5,31,45,4589,6092,279,481
Collin,18,10190,3739,6451,3220,5667,64,263,11,22,414,457,3,2,27,40,3549,6076,190,375
Collingsworth,5,182,97,85,84,79,8,3,4,2,0,0,0,0,1,1,62,46,35,39
Collingsworth,6,160,81,79,70,64,6,10,3,2,0,2,0,0,2,1,45,48,36,31
Collingsworth,7,174,80,94,71,84,5,5,3,4,0,0,0,0,1,1,49,50,31,44
Collingsworth,8,190,107,83,95,68,4,7,5,5,2,1,0,0,1,2,50,45,57,38
Collingsworth,9,145,70,75,64,70,3,5,2,0,1,0,0,0,0,0,51,45,19,30
Collingsworth,10,158,75,83,68,74,6,5,1,2,0,2,0,0,0,0,46,62,29,21
Collingsworth,11,169,85,84,79,73,3,7,2,3,1,1,0,0,0,0,62,53,23,31
Collingsworth,12,193,98,95,86,86,6,2,5,5,0,0,0,0,1,2,76,74,22,21
Collingsworth,13,186,87,99,82,89,4,5,0,2,0,0,0,0,1,3,64,86,23,13
Collingsworth,14,171,82,89,72,84,5,2,3,3,0,0,0,0,2,0,72,73,10,16
Collingsworth,15,134,62,72,59,68,2,4,1,0,0,0,0,0,0,0,56,66,6,6
Collingsworth,16,95,38,57,35,52,3,4,0,0,0,0,0,0,0,1,37,50,1,7
Collingsworth,17,74,33,41,32,38,1,2,0,0,0,0,0,0,0,1,33,39,0,2
Collingsworth,18,75,27,48,24,46,1,1,0,0,0,0,0,0,2,1,27,45,0,3
Colorado,5,1199,620,579,497,472,96,89,6,7,3,4,2,1,16,6,360,338,260,241
Colorado,6,1218,675,543,549,432,105,77,9,11,2,4,0,1,10,18,381,356,294,187
Colorado,7,1054,562,492,475,402,65,69,10,8,5,6,0,0,7,7,321,324,241,168
Colorado,8,1108,562,546,462,439,79,87,13,7,3,10,0,0,5,3,346,357,216,189
Colorado,9,1031,529,502,440,423,73,66,8,3,6,6,0,0,2,4,337,309,192,193
Colorado,10,1125,565,560,474,458,74,84,8,6,4,5,1,1,4,6,392,396,173,164
Colorado,11,1267,633,634,541,539,73,78,9,5,5,7,0,0,5,5,451,467,182,167
Colorado,12,1550,787,763,664,657,102,87,9,10,5,1,0,0,7,8,607,613,180,150
Colorado,13,1582,776,806,669,680,94,112,5,4,5,7,0,2,3,1,625,682,151,124
Colorado,14,1448,697,751,620,678,62,61,5,2,2,3,1,1,7,6,606,648,91,103
Colorado,15,1144,569,575,513,515,44,53,6,0,2,0,1,1,3,6,500,512,69,63
Colorado,16,904,435,469,394,428,41,39,0,0,0,1,0,0,0,1,394,425,41,44
Colorado,17,564,267,297,253,271,13,22,0,1,0,0,0,1,1,2,226,259,41,38
Colorado,18,670,235,435,226,406,7,24,1,0,0,2,0,0,1,3,221,409,14,26
Comal,5,7938,4030,3908,3691,3557,139,127,43,49,32,38,3,4,122,133,2478,2438,1552,1470
Comal,6,8192,4111,4081,3775,3773,158,120,40,40,50,58,11,9,77,81,2667,2719,1444,1362
Comal,7,8778,4318,4460,4016,4093,111,109,39,38,72,131,5,4,75,85,2807,3040,1511,1420
Comal,8,9237,4569,4668,4250,4330,122,107,34,39,98,96,6,4,59,92,3065,3189,1504,1479
Comal,9,8749,4439,4310,4108,3992,140,97,43,55,62,96,6,3,80,67,2968,2986,1471,1324
Comal,10,9895,4878,5017,4498,4678,187,122,62,54,73,93,5,8,53,62,3505,3591,1373,1426
Comal,11,9958,4910,5048,4528,4694,233,146,53,52,49,86,2,4,45,66,3759,3826,1151,1222
Comal,12,10970,5297,5673,4984,5299,174,160,37,53,36,97,1,6,65,58,4309,4579,988,1094
Comal,13,10859,5231,5628,4945,5353,148,107,39,39,39,70,3,2,57,57,4312,4697,919,931
Comal,14,9373,4516,4857,4336,4606,72,90,38,28,28,87,3,3,39,43,3850,4127,666,730
Comal,15,7372,3610,3762,3492,3597,60,51,24,10,13,51,3,4,18,49,3175,3193,435,569
Comal,16,4558,2232,2326,2152,2227,28,23,17,5,16,55,0,1,19,15,1955,2025,277,301
Comal,17,2867,1309,1558,1263,1510,17,19,5,11,12,6,2,0,10,12,1164,1330,145,228
Comal,18,2621,954,1667,934,1618,3,15,5,5,3,17,0,0,9,12,832,1436,122,231
Comanche,5,715,393,322,374,301,9,10,4,6,1,0,3,0,2,5,193,203,200,119
Comanche,6,677,334,343,323,322,3,4,3,13,0,2,0,0,5,2,202,214,132,129
Comanche,7,648,337,311,306,292,13,3,9,9,2,4,0,0,7,3,204,195,133,116
Comanche,8,683,332,351,319,338,1,1,4,5,4,4,2,0,2,3,212,232,120,119
Comanche,9,681,329,352,319,336,3,4,2,5,2,4,0,0,3,3,212,242,117,110
Comanche,10,784,373,411,358,396,9,3,4,4,0,6,0,0,2,2,253,279,120,132
Comanche,11,911,471,440,449,422,9,9,7,4,1,3,1,0,4,2,325,338,146,102
Comanche,12,916,462,454,447,428,6,0,7,14,0,9,0,0,2,3,370,363,92,91
Comanche,13,912,448,464,430,445,5,1,5,10,3,5,0,0,5,3,380,403,68,61
Comanche,14,967,487,480,465,466,0,4,8,1,6,2,0,0,8,7,415,414,72,66
Comanche,15,853,404,449,388,439,0,1,7,4,3,0,0,0,6,5,361,405,43,44
Comanche,16,673,320,353,318,350,1,0,1,1,0,0,0,0,0,2,301,332,19,21
Comanche,17,446,214,232,211,226,0,0,0,1,1,1,0,0,2,4,203,220,11,12
Comanche,18,374,154,220,151,212,0,0,0,3,0,1,0,1,3,3,144,206,10,14
Concho,5,134,70,64,65,59,2,2,0,2,1,0,0,0,2,1,24,40,46,24
Concho,6,116,59,57,55,52,2,0,1,3,0,0,0,0,1,2,35,37,24,20
Concho,7,131,81,50,72,47,7,1,1,0,1,1,0,0,0,1,31,23,50,27
Concho,8,144,83,61,78,58,4,2,0,0,0,1,0,0,1,0,32,38,51,23
Concho,9,146,82,64,76,62,5,0,0,1,1,1,0,0,0,0,34,41,48,23
Concho,10,156,90,66,80,64,3,0,1,0,6,1,0,0,0,1,49,44,41,22
Concho,11,201,128,73,98,70,3,1,0,2,27,0,0,0,0,0,88,45,40,28
Concho,12,202,110,92,106,85,0,3,1,2,2,0,0,0,1,2,81,77,29,15
Concho,13,210,91,119,91,116,0,0,0,1,0,0,0,0,0,2,65,97,26,22
Concho,14,207,107,100,103,95,3,1,1,1,0,0,0,0,0,3,75,74,32,26
Concho,15,174,89,85,88,85,1,0,0,0,0,0,0,0,0,0,75,72,14,13
Concho,16,132,77,55,73,54,0,1,2,0,0,0,1,0,1,0,66,41,11,14
Concho,17,100,47,53,46,53,0,0,0,0,0,0,0,0,1,0,39,48,8,5
Concho,18,74,31,43,31,43,0,0,0,0,0,0,0,0,0,0,24,33,7,10
Cooke,5,2493,1327,1166,1212,1039,43,53,26,21,11,17,2,2,33,34,895,856,432,310
Cooke,6,2606,1313,1293,1195,1184,50,46,28,20,18,16,2,3,20,24,1006,1022,307,271
Cooke,7,2320,1161,1159,1068,1072,47,38,24,12,11,19,0,0,11,18,914,917,247,242
Cooke,8,2289,1135,1154,1037,1069,46,24,23,17,18,17,0,0,11,27,893,921,242,233
Cooke,9,2150,1041,1109,946,1019,42,27,21,18,21,31,1,0,10,14,825,873,216,236
Cooke,10,2289,1101,1188,1032,1125,27,25,17,12,10,15,3,0,12,11,904,1016,197,172
Cooke,11,2530,1231,1299,1140,1199,41,43,20,24,10,24,2,0,18,9,1071,1124,160,175
Cooke,12,2904,1421,1483,1320,1406,48,39,21,20,17,9,1,0,14,9,1253,1349,168,134
Cooke,13,2858,1414,1444,1343,1350,40,45,9,16,11,12,0,0,11,21,1284,1349,130,95
Cooke,14,2484,1231,1253,1178,1188,18,33,16,14,6,9,0,0,13,9,1164,1181,67,72
Cooke,15,1918,896,1022,849,979,20,19,12,6,3,7,0,0,12,11,859,979,37,43
Cooke,16,1390,666,724,647,690,8,9,1,10,3,3,0,1,7,11,642,703,24,21
Cooke,17,896,375,521,356,500,4,9,6,1,3,4,0,0,6,7,360,501,15,20
Cooke,18,850,355,495,334,459,12,12,2,3,2,9,0,0,5,12,340,481,15,14
Coryell,5,7711,4677,3034,3416,2118,812,651,59,45,120,67,43,13,227,140,3778,2308,899,726
Coryell,6,7749,4005,3744,2893,2659,778,773,48,51,99,93,45,23,142,145,3182,3002,823,742
Coryell,7,6719,3402,3317,2403,2384,758,685,33,37,56,52,39,51,113,108,2625,2628,777,689
Coryell,8,5977,2924,3053,2104,2197,638,622,25,33,43,77,28,31,86,93,2224,2466,700,587
Coryell,9,5101,2343,2758,1660,1940,527,615,20,27,38,78,37,37,61,61,1832,2268,511,490
Coryell,10,4613,2129,2484,1609,1820,395,543,27,21,40,46,14,15,44,39,1773,2135,356,349
Coryell,11,3789,1754,2035,1357,1526,302,398,23,20,22,40,13,16,37,35,1508,1791,246,244
Coryell,12,3476,1617,1859,1287,1438,262,284,20,29,23,62,6,14,19,32,1412,1635,205,224
Coryell,13,3147,1421,1726,1128,1373,227,203,16,16,19,79,14,22,17,33,1293,1528,128,198
Coryell,14,2501,1147,1354,977,1103,128,136,9,17,12,68,9,4,12,26,1038,1217,109,137
Coryell,15,2082,885,1197,775,991,75,111,14,6,9,70,2,6,10,13,812,1104,73,93
Coryell,16,1455,628,827,559,700,51,56,6,13,3,42,4,2,5,14,586,778,42,49
Coryell,17,941,366,575,331,480,18,65,6,2,7,22,0,1,4,5,344,541,22,34
Coryell,18,712,290,422,258,360,21,30,4,5,2,23,2,1,3,3,263,392,27,30
Cottle,5,58,33,25,24,20,8,3,0,0,0,0,0,1,1,1,23,18,10,7
Cottle,6,61,33,28,19,25,14,3,0,0,0,0,0,0,0,0,25,23,8,5
Cottle,7,77,40,37,37,28,1,5,2,2,0,0,0,0,0,2,21,25,19,12
Cottle,8,83,36,47,34,43,2,3,0,0,0,0,0,0,0,1,20,31,16,16
Cottle,9,68,32,36,26,30,6,5,0,0,0,0,0,0,0,1,23,23,9,13
Cottle,10,62,26,36,20,30,6,5,0,1,0,0,0,0,0,0,18,30,8,6
Cottle,11,78,34,44,33,35,1,9,0,0,0,0,0,0,0,0,21,37,13,7
Cottle,12,111,57,54,51,47,5,6,0,0,0,1,0,0,1,0,44,44,13,10
Cottle,13,105,50,55,45,52,5,2,0,0,0,0,0,0,0,1,36,44,14,11
Cottle,14,96,41,55,38,52,2,3,0,0,0,0,0,0,1,0,39,50,2,5
Cottle,15,82,46,36,42,34,2,2,0,0,0,0,1,0,1,0,40,32,6,4
Cottle,16,72,27,45,21,41,5,3,0,0,0,0,0,0,1,1,25,43,2,2
Cottle,17,43,21,22,20,20,0,1,0,1,0,0,0,0,1,0,20,18,1,4
Cottle,18,39,10,29,9,27,1,2,0,0,0,0,0,0,0,0,7,23,3,6
Crane,5,312,156,156,141,138,6,5,4,4,1,2,0,0,4,7,38,40,118,116
Crane,6,324,172,152,154,137,9,4,5,5,1,3,0,1,3,2,54,43,118,109
Crane,7,296,167,129,147,123,12,3,3,0,1,1,0,0,4,2,51,35,116,94
Crane,8,307,147,160,136,150,7,2,3,3,1,2,0,0,0,3,47,49,100,111
Crane,9,292,152,140,137,126,5,6,5,1,1,3,0,0,4,4,37,45,115,95
Crane,10,273,127,146,110,142,5,3,4,0,3,0,0,0,5,1,38,57,89,89
Crane,11,279,148,131,141,127,2,3,2,0,2,0,1,0,0,1,57,63,91,68
Crane,12,313,167,146,156,136,7,2,1,4,2,3,0,0,1,1,77,74,90,72
Crane,13,261,129,132,120,123,4,5,2,0,1,2,0,1,2,1,63,66,66,66
Crane,14,175,92,83,82,76,6,2,3,4,0,1,0,0,1,0,47,46,45,37
Crane,15,125,54,71,50,63,1,5,0,1,0,1,0,0,3,1,31,45,23,26
Crane,16,105,47,58,46,55,0,3,0,0,1,0,0,0,0,0,24,36,23,22
Crane,17,81,32,49,31,46,1,1,0,1,0,1,0,0,0,0,19,29,13,20
Crane,18,82,26,56,24,50,0,3,1,0,1,3,0,0,0,0,18,44,8,12
Crockett,5,187,82,105,76,100,2,1,3,3,0,0,0,0,1,1,19,23,63,82
Crockett,6,189,93,96,88,93,3,2,2,0,0,0,0,0,0,1,29,43,64,53
Crockett,7,192,106,86,92,79,3,2,6,2,1,2,0,0,4,1,36,26,70,60
Crockett,8,234,109,125,98,114,3,2,2,8,3,0,1,0,2,1,31,31,78,94
Crockett,9,185,98,87,92,82,1,1,2,2,1,2,0,0,2,0,23,25,75,62
Crockett,10,216,119,97,111,94,2,2,4,0,2,1,0,0,0,0,34,35,85,62
Crockett,11,225,108,117,98,110,5,3,1,2,0,1,0,0,4,1,41,42,67,75
Crockett,12,220,121,99,118,97,1,0,2,2,0,0,0,0,0,0,55,52,66,47
Crockett,13,258,137,121,133,115,0,1,2,1,0,3,0,0,2,1,57,62,80,59
Crockett,14,185,87,98,79,95,1,0,1,1,1,0,1,1,4,1,35,38,52,60
Crockett,15,165,82,83,78,79,0,1,3,3,0,0,0,0,1,0,42,37,40,46
Crockett,16,119,46,73,41,69,1,1,2,1,1,1,0,0,1,1,21,32,25,41
Crockett,17,66,37,29,35,29,1,0,1,0,0,0,0,0,0,0,15,14,22,15
Crockett,18,58,24,34,23,33,1,1,0,0,0,0,0,0,0,0,12,10,12,24
Crosby,5,322,153,169,133,150,9,4,2,6,0,2,0,0,9,7,60,54,93,115
Crosby,6,343,176,167,161,162,6,1,2,0,1,1,2,0,4,3,59,60,117,107
Crosby,7,317,178,139,156,133,12,5,1,0,1,1,0,0,8,0,68,54,110,85
Crosby,8,361,185,176,173,165,8,5,2,3,0,0,0,1,2,2,67,72,118,104
Crosby,9,304,153,151,142,140,4,7,2,2,2,0,0,0,3,2,58,57,95,94
Crosby,10,294,138,156,128,144,2,6,3,1,0,1,0,0,5,4,51,72,87,84
Crosby,11,320,151,169,141,156,6,5,3,3,0,0,0,0,1,5,72,73,79,96
Crosby,12,376,191,185,175,177,8,6,4,1,0,0,1,0,3,1,105,98,86,87
Crosby,13,365,183,182,173,172,8,4,1,5,0,0,0,0,1,1,111,103,72,79
Crosby,14,312,166,146,160,139,3,3,1,2,1,1,0,0,1,1,95,95,71,51
Crosby,15,244,110,134,99,126,2,7,3,1,1,0,0,0,5,0,69,75,41,59
Crosby,16,230,109,121,103,112,4,6,2,3,0,0,0,0,0,0,76,84,33,37
Crosby,17,146,60,86,54,82,4,3,1,1,0,0,0,0,1,0,46,66,14,20
Crosby,18,145,50,95,47,88,2,7,1,0,0,0,0,0,0,0,38,79,12,16
Culberson,5,141,79,62,63,58,1,0,4,1,2,1,0,0,9,2,19,18,60,44
Culberson,6,141,78,63,72,56,1,0,1,1,2,1,0,0,2,5,23,20,55,43
Culberson,7,112,57,55,47,48,2,0,0,4,2,2,1,0,5,1,19,13,38,42
Culberson,8,118,65,53,60,48,4,0,0,2,1,2,0,0,0,1,13,12,52,41
Culberson,9,93,44,49,42,44,0,1,0,0,2,3,0,0,0,1,12,11,32,38
Culberson,10,121,54,67,54,63,0,2,0,1,0,0,0,0,0,1,15,15,39,52
Culberson,11,147,68,79,65,72,0,0,2,0,1,3,0,0,0,4,19,20,49,59
Culberson,12,151,77,74,74,68,0,0,2,3,0,0,0,0,1,3,22,17,55,57
Culberson,13,152,72,80,62,77,2,0,4,1,2,1,0,0,2,1,28,32,44,48
Culberson,14,140,60,80,54,74,0,0,4,3,2,2,0,0,0,1,28,24,32,56
Culberson,15,124,61,63,59,60,0,0,0,2,2,0,0,0,0,1,20,15,41,48
Culberson,16,74,38,36,35,33,1,3,1,0,1,0,0,0,0,0,15,10,23,26
Culberson,17,64,19,45,16,42,0,0,0,0,1,3,0,0,2,0,8,17,11,28
Culberson,18,71,35,36,35,36,0,0,0,0,0,0,0,0,0,0,17,10,18,26
Dallam,5,438,235,203,210,195,8,3,6,3,3,1,1,0,7,1,81,90,154,113
Dallam,6,544,306,238,271,226,11,3,15,1,4,5,2,0,3,3,166,144,140,94
Dallam,7,524,274,250,240,233,17,3,6,8,5,3,0,1,6,2,155,133,119,117
Dallam,8,442,231,211,216,197,5,2,5,6,4,3,1,0,0,3,124,114,107,97
Dallam,9,356,169,187,154,163,4,10,5,4,3,8,0,0,3,2,86,109,83,78
Dallam,10,484,257,227,241,219,4,1,4,5,1,0,2,1,5,1,138,129,119,98
Dallam,11,430,224,206,205,196,11,3,5,4,2,0,0,0,1,3,136,119,88,87
Dallam,12,408,223,185,208,175,8,3,4,2,2,4,0,0,1,1,137,111,86,74
Dallam,13,327,173,154,161,139,4,4,5,6,3,1,0,2,0,2,120,106,53,48
Dallam,14,297,164,133,154,125,2,3,4,2,0,1,0,0,4,2,122,96,42,37
Dallam,15,200,95,105,88,99,1,2,4,4,1,0,0,0,1,0,65,72,30,33
Dallam,16,146,75,71,72,68,1,1,0,2,0,0,0,0,2,0,50,50,25,21
Dallam,17,91,42,49,39,49,2,0,1,0,0,0,0,0,0,0,35,37,7,12
Dallam,18,94,32,62,29,55,1,1,0,2,0,0,0,0,2,4,21,46,11,16
Dallas,5,182334,91944,90390,61802,60175,21506,21277,1187,1252,5325,5531,105,136,2019,2019,47265,47481,44679,42909
Dallas,6,227482,113299,114183,75690,72247,25511,28767,1318,1242,8567,9301,126,160,2087,2466,67972,71262,45327,42921
Dallas,7,207960,105007,102953,70020,64445,21951,26259,1147,1040,10037,9219,121,111,1731,1879,63454,65446,41553,37507
Dallas,8,190133,95481,94652,64190,58589,20122,25299,1220,1048,8383,8019,125,112,1441,1585,54857,57477,40624,37175
Dallas,9,170994,83971,87023,57029,54783,17465,22886,1207,1038,7155,6959,115,112,1000,1245,45981,50310,37990,36713
Dallas,10,168560,82737,85823,56166,53929,17984,23306,1024,992,6441,6385,105,109,1017,1102,48563,52624,34174,33199
Dallas,11,158234,79049,79185,54504,50492,17904,22147,985,828,4817,4663,82,92,757,963,48598,52064,30451,27121
Dallas,12,155579,76437,79142,53257,51615,17689,21556,719,750,3953,4359,64,66,755,796,53009,57692,23428,21450
Dallas,13,131269,63003,68266,44058,44997,14251,17963,510,553,3543,4055,53,55,588,643,46939,52650,16064,15616
Dallas,14,100144,45945,54199,32655,35874,9596,13897,349,349,2871,3545,34,30,440,504,35687,43617,10258,10582
Dallas,15,72580,32397,40183,23610,27750,6282,9407,221,275,1954,2347,28,30,302,374,26264,33068,6133,7115
Dallas,16,47390,20253,27137,15006,19277,3663,5960,131,157,1282,1532,1,11,170,200,16772,22698,3481,4439
Dallas,17,30371,12178,18193,9293,13545,2025,3557,79,111,707,846,4,17,70,117,10177,15411,2001,2782
Dallas,18,31796,10732,21064,8697,16384,1442,3677,64,98,481,791,0,6,48,108,9127,18534,1605,2530
Dawson,5,920,612,308,505,286,86,8,9,6,5,1,0,0,7,7,241,93,371,215
Dawson,6,1059,696,363,582,324,91,10,8,5,4,17,1,0,10,7,318,135,378,228
Dawson,7,935,613,322,513,299,62,8,12,3,22,7,1,0,3,5,254,106,359,216
Dawson,8,840,514,326,447,307,43,13,9,4,9,0,1,0,5,2,194,116,320,210
Dawson,9,726,407,319,350,302,40,11,5,2,5,1,2,0,5,3,165,113,242,206
Dawson,10,634,344,290,295,269,36,8,6,6,2,2,0,0,5,5,160,124,184,166
Dawson,11,616,319,297,291,281,17,9,4,3,3,3,1,0,3,1,138,120,181,177
Dawson,12,733,370,363,342,340,21,18,5,1,2,2,0,0,0,2,180,167,190,196
Dawson,13,658,322,336,286,311,25,17,6,4,1,0,1,0,3,4,177,192,145,144
Dawson,14,541,258,283,242,258,11,16,3,4,0,1,0,3,2,1,150,170,108,113
Dawson,15,475,205,270,185,251,9,12,3,1,3,3,0,1,5,2,111,174,94,96
Dawson,16,368,159,209,151,196,4,6,1,2,0,1,0,1,3,3,96,134,63,75
Dawson,17,262,106,156,100,151,1,3,2,0,0,0,1,0,2,2,79,109,27,47
Dawson,18,239,101,138,96,130,3,6,0,2,0,0,0,0,2,0,65,104,36,34
Deaf,5,1327,677,650,639,611,9,21,16,7,4,6,2,0,7,5,125,105,552,545
Deaf,6,1354,705,649,640,596,24,29,24,12,4,5,0,0,13,7,131,128,574,521
Deaf,7,1148,578,570,542,537,10,14,12,9,4,6,0,0,10,4,111,106,467,464
Deaf,8,1084,555,529,524,497,8,6,11,11,5,5,0,1,7,9,130,119,425,410
Deaf,9,1100,551,549,506,527,21,8,14,11,3,0,0,0,7,3,141,115,410,434
Deaf,10,1002,490,512,461,485,17,15,8,5,1,4,0,0,3,3,128,154,362,358
Deaf,11,1016,500,516,478,493,9,7,6,7,4,4,1,0,2,5,146,149,354,367
Deaf,12,961,495,466,476,443,11,6,0,12,4,0,1,1,3,4,184,191,311,275
Deaf,13,966,457,509,437,494,10,5,7,5,0,2,1,0,2,3,195,223,262,286
Deaf,14,833,420,413,403,390,6,10,7,7,2,4,1,0,1,2,208,214,212,199
Deaf,15,523,222,301,209,283,4,5,3,5,2,4,1,1,3,3,130,167,92,134
Deaf,16,392,203,189,195,184,1,1,4,3,0,1,0,0,3,0,117,109,86,80
Deaf,17,304,118,186,116,180,0,1,2,2,0,0,0,0,0,3,72,124,46,62
Deaf,18,336,131,205,121,196,3,3,3,4,0,0,0,0,4,2,84,158,47,47
Delta,5,249,128,121,103,98,13,9,4,4,0,0,0,0,8,10,107,108,21,13
Delta,6,318,155,163,126,147,17,8,4,4,1,0,0,1,7,3,145,148,10,15
Delta,7,267,131,136,107,124,15,11,6,1,1,0,0,0,2,0,118,121,13,15
Delta,8,330,167,163,152,146,8,7,3,3,3,2,0,0,1,5,142,145,25,18
Delta,9,277,158,119,133,105,18,5,1,4,1,1,0,0,5,4,135,109,23,10
Delta,10,318,150,168,131,149,14,6,2,6,1,1,0,0,2,6,135,152,15,16
Delta,11,347,161,186,141,165,12,11,5,3,1,3,0,0,2,4,149,172,12,14
Delta,12,337,175,162,158,149,11,5,4,1,2,1,0,0,0,6,164,160,11,2
Delta,13,419,210,209,190,186,7,6,6,12,1,2,0,0,6,3,200,197,10,12
Delta,14,341,155,186,133,170,12,11,5,0,2,2,0,0,3,3,148,185,7,1
Delta,15,284,147,137,140,124,4,7,1,1,2,2,0,0,0,3,143,137,4,0
Delta,16,249,131,118,121,104,5,9,4,4,0,0,0,0,1,1,127,116,4,2
Delta,17,126,64,62,56,52,8,7,0,3,0,0,0,0,0,0,61,60,3,2
Delta,18,98,34,64,33,56,1,3,0,0,0,1,0,0,0,4,33,64,1,0
Denton,5,55961,27686,28275,20753,20595,3552,4009,326,295,2122,2296,26,53,907,1027,20739,21232,6947,7043
Denton,6,62449,30859,31590,22868,22545,4070,4501,307,304,2808,3243,31,40,775,957,23916,24999,6943,6591
Denton,7,64648,31869,32779,23699,23205,3781,4462,281,245,3411,4006,58,51,639,810,25147,26256,6722,6523
Denton,8,67072,32672,34400,24109,24219,3715,4586,276,284,3876,4616,45,30,651,665,25784,27476,6888,6924
Denton,9,65115,31811,33304,23368,24169,3352,3932,271,278,4200,4304,50,25,570,596,25158,26809,6653,6495
Denton,10,66645,33091,33554,25503,25485,3203,3734,272,290,3576,3512,32,20,505,513,27248,27818,5843,5736
Denton,11,57635,28957,28678,23207,22723,2649,2919,222,230,2493,2343,27,31,359,432,24496,24278,4461,4400
Denton,12,54118,26659,27459,22090,22358,2252,2573,217,199,1795,1991,24,25,281,313,23386,24201,3273,3258
Denton,13,42303,20173,22130,16904,18182,1529,1914,155,142,1331,1606,15,21,239,265,18107,19805,2066,2325
Denton,14,31869,14732,17137,12597,14430,885,1217,89,157,1021,1154,16,14,124,165,13436,15526,1296,1611
Denton,15,24557,11232,13325,9875,11679,462,633,88,83,691,802,10,5,106,123,10317,12290,915,1035
Denton,16,15085,6807,8278,5971,7300,226,349,46,42,500,514,4,6,60,67,6315,7623,492,655
Denton,17,8572,3641,4931,3212,4340,136,206,17,30,251,313,5,0,20,42,3358,4538,283,393
Denton,18,7397,2601,4796,2373,4340,57,180,8,24,134,204,4,3,25,45,2416,4406,185,390
DeWitt,5,955,501,454,438,395,51,41,1,4,2,4,0,0,9,10,290,264,211,190
DeWitt,6,1157,631,526,528,468,86,46,9,6,3,1,0,0,5,5,375,328,256,198
DeWitt,7,1245,723,522,593,470,115,40,8,3,0,2,0,0,7,7,399,292,324,230
DeWitt,8,1317,778,539,645,479,116,44,7,7,0,3,3,0,7,6,433,309,345,230
DeWitt,9,1241,758,483,631,446,109,28,12,4,3,3,1,0,2,2,439,283,319,200
DeWitt,10,1228,714,514,595,464,104,40,7,5,3,1,1,0,4,4,447,364,267,150
DeWitt,11,1280,724,556,626,493,78,46,10,8,5,5,2,0,3,4,470,401,254,155
DeWitt,12,1440,761,679,668,614,72,49,10,9,2,2,0,0,9,5,537,470,224,209
DeWitt,13,1324,676,648,612,592,51,48,7,2,1,2,0,0,5,4,495,496,181,152
DeWitt,14,1188,557,631,504,581,40,41,6,3,3,2,0,0,4,4,443,514,114,117
DeWitt,15,969,461,508,416,458,34,38,8,5,1,4,0,0,2,3,379,402,82,106
DeWitt,16,699,305,394,288,358,15,27,1,4,0,1,0,0,1,4,252,326,53,68
DeWitt,17,560,220,340,206,321,11,17,2,1,0,1,0,0,1,0,187,273,33,67
DeWitt,18,565,184,381,181,350,1,21,2,3,0,2,0,0,0,5,142,311,42,70
Dickens,5,124,86,38,63,35,15,1,4,0,1,1,0,0,3,1,40,23,46,15
Dickens,6,163,127,36,106,31,14,3,4,0,2,1,0,0,1,1,64,26,63,10
Dickens,7,147,108,39,86,36,16,0,0,0,3,1,0,0,3,2,52,21,56,18
Dickens,8,118,73,45,66,40,6,3,0,1,0,1,0,0,1,0,42,28,31,17
Dickens,9,158,92,66,76,64,9,1,3,0,3,1,0,0,1,0,56,43,36,23
Dickens,10,122,73,49,66,44,4,1,2,1,1,1,0,1,0,1,50,37,23,12
Dickens,11,97,47,50,39,48,5,1,2,1,0,0,0,0,1,0,31,37,16,13
Dickens,12,146,79,67,73,62,2,1,1,3,3,1,0,0,0,0,62,54,17,13
Dickens,13,152,82,70,74,65,3,1,3,1,1,1,0,0,1,2,67,60,15,10
Dickens,14,133,49,84,47,77,0,3,0,1,0,1,0,0,2,2,42,69,7,15
Dickens,15,136,61,75,56,72,2,0,1,1,0,0,0,0,2,2,50,64,11,11
Dickens,16,115,51,64,49,64,0,0,1,0,1,0,0,0,0,0,45,62,6,2
Dickens,17,61,26,35,23,33,3,2,0,0,0,0,0,0,0,0,25,31,1,4
Dickens,18,59,27,32,22,27,0,0,4,3,0,0,0,1,1,1,25,27,2,5
Dimmit,5,636,313,323,299,307,8,5,0,2,3,3,0,0,3,6,26,27,287,296
Dimmit,6,638,325,313,308,296,4,7,3,3,4,5,0,0,6,2,39,38,286,275
Dimmit,7,615,325,290,311,279,3,2,4,1,2,4,0,1,5,3,42,34,283,256
Dimmit,8,612,304,308,294,301,5,3,0,4,2,0,0,0,3,0,40,41,264,267
Dimmit,9,599,291,308,282,303,6,2,1,0,0,2,0,0,2,1,50,35,241,273
Dimmit,10,524,253,271,243,259,3,4,4,2,1,3,0,0,2,3,33,32,220,239
Dimmit,11,539,248,291,240,275,3,6,2,4,2,6,0,0,1,0,30,37,218,254
Dimmit,12,575,292,283,272,276,13,4,3,2,3,0,0,0,1,1,62,33,230,250
Dimmit,13,532,262,270,237,256,9,7,8,0,5,5,0,1,3,1,50,44,212,226
Dimmit,14,519,223,296,212,285,1,3,3,2,6,2,0,0,1,4,41,37,182,259
Dimmit,15,439,216,223,215,219,0,1,0,1,1,0,0,0,0,2,31,35,185,188
Dimmit,16,292,126,166,122,162,2,1,2,1,0,1,0,0,0,1,35,28,91,138
Dimmit,17,207,86,121,83,117,1,2,2,2,0,0,0,0,0,0,12,12,74,109
Dimmit,18,244,98,146,94,137,0,4,3,3,1,1,0,0,0,1,25,35,73,111
Donley,5,245,140,105,127,79,10,18,1,2,1,3,0,0,1,3,115,85,25,20
Donley,6,151,73,78,64,64,7,10,0,3,2,1,0,0,0,0,68,75,5,3
Donley,7,128,70,58,65,55,2,0,0,0,0,1,0,0,3,2,49,47,21,11
Donley,8,196,95,101,90,92,5,6,0,1,0,1,0,0,0,1,79,83,16,18
Donley,9,165,75,90,69,86,3,4,1,0,1,0,0,0,1,0,66,74,9,16
Donley,10,138,71,67,59,62,10,2,0,1,0,2,1,0,1,0,59,62,12,5
Donley,11,181,81,100,77,90,2,6,0,2,1,0,0,0,1,2,77,94,4,6
Donley,12,218,115,103,108,96,3,4,1,0,2,0,0,1,1,2,101,93,14,10
Donley,13,247,113,134,107,123,3,8,2,0,0,2,0,0,1,1,109,127,4,7
Donley,14,236,114,122,102,117,8,2,4,3,0,0,0,0,0,0,108,120,6,2
Donley,15,188,73,115,71,110,1,2,0,3,1,0,0,0,0,0,66,111,7,4
Donley,16,159,77,82,72,78,2,3,1,0,0,0,0,0,2,1,76,80,1,2
Donley,17,119,59,60,56,55,2,2,0,2,0,0,0,0,1,1,56,60,3,0
Donley,18,91,37,54,35,50,1,4,0,0,0,0,0,0,1,0,37,54,0,0
Duval,5,820,458,362,429,351,14,4,9,1,0,2,1,0,5,4,55,23,403,339
Duval,6,758,461,297,442,289,11,3,4,2,2,2,0,0,2,1,51,22,410,275
Duval,7,649,344,305,329,294,10,1,2,4,0,5,1,0,2,1,38,29,306,276
Duval,8,657,353,304,336,296,10,0,4,4,2,1,0,2,1,1,39,24,314,280
Duval,9,634,336,298,316,294,16,1,0,3,0,0,0,0,4,0,54,25,282,273
Duval,10,613,325,288,300,276,16,2,6,8,1,2,0,0,2,0,49,31,276,257
Duval,11,624,317,307,296,303,11,1,4,2,3,0,0,0,3,1,51,16,266,291
Duval,12,682,343,339,323,330,8,2,6,2,3,3,1,1,2,1,44,36,299,303
Duval,13,581,279,302,266,301,6,0,3,0,0,0,0,0,4,1,33,27,246,275
Duval,14,496,250,246,246,242,1,1,3,1,0,2,0,0,0,0,28,37,222,209
Duval,15,551,255,296,248,289,2,1,2,1,2,3,0,0,1,2,36,39,219,257
Duval,16,438,203,235,203,229,0,0,0,5,0,1,0,0,0,0,23,32,180,203
Duval,17,257,104,153,103,152,0,0,0,1,0,0,0,0,1,0,18,19,86,134
Duval,18,272,111,161,110,160,1,0,0,1,0,0,0,0,0,0,25,25,86,136
Eastland,5,1156,632,524,551,481,58,24,13,8,4,2,0,0,6,9,464,393,168,131
Eastland,6,989,526,463,500,438,9,5,8,8,2,4,0,0,7,8,399,354,127,109
Eastland,7,904,464,440,435,417,12,5,5,4,2,12,1,0,9,2,354,344,110,96
Eastland,8,1041,512,529,492,491,6,16,6,12,4,5,1,0,3,5,417,440,95,89
Eastland,9,910,465,445,446,417,11,3,4,9,0,10,0,1,4,5,373,384,92,61
Eastland,10,950,459,491,439,474,2,2,8,3,6,8,0,0,4,4,365,403,94,88
Eastland,11,1068,515,553,499,531,6,4,6,9,3,6,0,0,1,3,426,480,89,73
Eastland,12,1351,664,687,639,661,4,10,8,5,6,3,1,1,6,7,567,607,97,80
Eastland,13,1325,676,649,647,621,10,11,11,3,3,5,0,0,5,9,608,603,68,46
Eastland,14,1137,572,565,551,548,7,6,6,5,1,3,1,1,6,2,525,530,47,35
Eastland,15,1065,484,581,468,566,3,2,4,5,0,2,1,1,8,5,451,555,33,26
Eastland,16,776,370,406,353,394,4,4,7,2,0,1,1,0,5,5,358,381,12,25
Eastland,17,529,247,282,241,273,0,2,2,2,1,2,1,0,2,3,238,276,9,6
Eastland,18,502,186,316,183,306,1,4,1,3,0,0,0,0,1,3,175,310,11,6
Ector,5,11557,6023,5534,5388,4968,360,277,116,77,52,68,8,64,99,80,1865,1723,4158,3811
Ector,6,14344,7629,6715,6846,6114,443,309,129,109,83,81,20,10,108,92,2585,2295,5044,4420
Ector,7,13027,6968,6059,6249,5440,404,319,135,112,81,105,22,12,77,71,2544,2303,4424,3756
Ector,8,11506,6121,5385,5571,4842,309,299,73,63,81,103,18,15,69,63,2230,2093,3891,3292
Ector,9,9577,4974,4603,4436,4163,310,235,83,61,87,92,15,17,43,35,1820,1638,3154,2965
Ector,10,8703,4378,4325,3980,3944,210,180,78,66,71,80,9,12,30,43,1672,1708,2706,2617
Ector,11,8256,4136,4120,3769,3805,200,187,69,36,55,67,9,4,34,21,1770,1774,2366,2346
Ector,12,8423,4150,4273,3827,3924,185,201,63,68,39,44,7,5,29,31,2162,2240,1988,2033
Ector,13,7302,3630,3672,3329,3347,158,170,67,54,39,56,2,6,35,39,2050,2059,1580,1613
Ector,14,5386,2633,2753,2412,2561,115,117,53,37,28,24,3,2,22,12,1517,1577,1116,1176
Ector,15,3912,1819,2093,1695,1938,55,89,33,30,13,18,3,0,20,18,1106,1277,713,816
Ector,16,2648,1089,1559,1008,1454,41,67,22,10,9,16,1,2,8,10,680,1019,409,540
Ector,17,1928,785,1143,730,1062,28,52,13,10,6,4,0,0,8,15,488,805,297,338
Ector,18,1763,611,1152,553,1054,26,57,10,21,9,11,0,2,13,7,411,844,200,308
Edwards,5,74,34,40,32,34,0,1,2,5,0,0,0,0,0,0,6,9,28,31
Edwards,6,97,54,43,49,40,3,3,1,0,0,0,0,0,1,0,21,11,33,32
Edwards,7,76,38,38,36,37,0,0,2,1,0,0,0,0,0,0,12,16,26,22
Edwards,8,97,50,47,50,44,0,0,0,1,0,1,0,0,0,1,10,17,40,30
Edwards,9,80,43,37,40,34,1,1,2,2,0,0,0,0,0,0,19,12,24,25
Edwards,10,94,46,48,43,46,0,1,2,0,1,1,0,0,0,0,14,21,32,27
Edwards,11,101,55,46,54,43,0,0,0,3,0,0,0,0,1,0,24,20,31,26
Edwards,12,127,56,71,55,65,0,2,0,3,1,0,0,0,0,1,24,37,32,34
Edwards,13,137,69,68,65,64,1,0,3,3,0,1,0,0,0,0,36,34,33,34
Edwards,14,180,90,90,86,82,0,3,2,1,0,1,0,0,2,3,55,67,35,23
Edwards,15,158,97,61,96,59,0,0,0,2,1,0,0,0,0,0,69,33,28,28
Edwards,16,100,50,50,49,49,0,0,0,0,0,0,0,0,1,1,33,34,17,16
Edwards,17,62,34,28,33,28,1,0,0,0,0,0,0,0,0,0,20,18,14,10
Edwards,18,50,22,28,22,28,0,0,0,0,0,0,0,0,0,0,12,12,10,16
Ellis,5,11049,5756,5293,4821,4396,697,650,59,58,44,46,9,15,126,128,3639,3451,2117,1842
Ellis,6,11401,5638,5763,4731,4872,694,657,57,57,36,49,5,6,115,122,3811,3913,1827,1850
Ellis,7,11858,5713,6145,4914,5180,605,710,53,63,47,76,10,8,84,108,3865,4347,1848,1798
Ellis,8,12155,5961,6194,5139,5138,645,817,48,65,52,74,11,16,66,84,4106,4472,1855,1722
Ellis,9,11476,5456,6020,4653,4992,646,814,42,54,42,63,4,11,69,86,3922,4381,1534,1639
Ellis,10,12237,6071,6166,5117,5155,763,830,58,37,51,64,8,8,74,72,4624,4824,1447,1342
Ellis,11,11449,5718,5731,4918,4808,655,748,51,50,38,60,7,6,49,59,4450,4506,1268,1225
Ellis,12,11630,5745,5885,5008,5078,596,672,62,43,28,43,3,8,48,41,4714,5030,1031,855
Ellis,13,10350,5070,5280,4414,4591,535,550,49,38,24,48,7,4,41,49,4355,4550,715,730
Ellis,14,8147,3816,4331,3360,3781,376,441,17,27,22,41,2,4,39,37,3302,3819,514,512
Ellis,15,6138,2850,3288,2572,2904,223,286,24,24,8,35,3,1,20,38,2517,2939,333,349
Ellis,16,4081,1843,2238,1704,2032,92,159,16,12,12,13,2,0,17,22,1656,2026,187,212
Ellis,17,2396,995,1401,893,1286,73,96,5,3,5,7,1,3,18,6,885,1267,110,134
Ellis,18,2246,773,1473,718,1332,41,104,2,16,5,5,0,0,7,16,691,1390,82,83
El,5,69703,37754,31949,33668,29242,2425,1371,407,367,458,388,95,75,701,506,8989,4704,28765,27245
El,6,67985,35912,32073,31862,29279,2357,1412,443,362,555,491,82,75,613,454,8202,5487,27710,26586
El,7,57897,30019,27878,26940,25427,1696,1084,394,337,491,559,102,74,396,397,6295,4706,23724,23172
El,8,53469,26804,26665,23876,24377,1611,1013,391,291,475,541,92,89,359,354,5730,4216,21074,22449
El,9,50527,24750,25777,22350,23865,1261,824,358,289,408,451,77,66,296,282,4698,3520,20052,22257
El,10,49881,23772,26109,21721,24536,1120,734,285,233,395,387,52,36,199,183,4363,3292,19409,22817
El,11,45800,21596,24204,19908,22814,945,640,232,208,291,334,38,40,182,168,4419,3342,17177,20862
El,12,46538,21474,25064,20070,23676,838,612,192,227,204,335,19,49,151,165,4332,3814,17142,21250
El,13,40843,18705,22138,17345,20968,744,527,204,183,220,291,39,17,153,152,4131,3754,14574,18384
El,14,32737,14843,17894,13996,16960,452,372,120,167,151,276,19,18,105,101,3478,3276,11365,14618
El,15,25375,11479,13896,10873,13165,301,293,73,115,138,233,17,19,77,71,2972,2716,8507,11180
El,16,17926,7483,10443,7133,9902,206,219,58,69,44,173,11,12,31,68,1885,2182,5598,8261
El,17,13036,5170,7866,4895,7512,149,169,34,37,45,114,7,6,40,28,1282,1601,3888,6265
El,18,13185,4676,8509,4430,8088,147,162,46,64,26,166,1,1,26,28,1147,1858,3529,6651
Erath,5,5666,2795,2871,2538,2680,138,114,26,36,30,9,1,6,62,26,2286,2368,509,503
Erath,6,2973,1498,1475,1384,1381,39,20,27,26,27,15,0,0,21,33,1094,1110,404,365
Erath,7,2434,1240,1194,1168,1128,26,18,13,21,13,12,0,2,20,13,869,873,371,321
Erath,8,2243,1092,1151,1030,1091,22,17,15,12,16,22,2,0,7,9,802,856,290,295
Erath,9,2076,1037,1039,997,986,15,11,8,8,10,17,0,2,7,15,809,810,228,229
Erath,10,2103,1024,1079,973,1035,6,5,11,23,19,6,0,2,15,8,811,811,213,268
Erath,11,2148,1070,1078,1011,1029,13,12,22,12,11,12,0,0,13,13,783,883,287,195
Erath,12,2461,1244,1217,1182,1171,19,17,16,13,15,6,1,1,11,9,1009,1055,235,162
Erath,13,2230,1123,1107,1066,1076,8,6,27,9,4,6,1,0,17,10,945,1004,178,103
Erath,14,1927,907,1020,869,993,6,4,14,8,4,5,0,0,14,10,814,949,93,71
Erath,15,1563,755,808,732,777,3,3,7,8,4,7,3,1,6,12,697,764,58,44
Erath,16,1011,479,532,467,521,0,1,3,2,2,2,0,0,7,6,448,518,31,14
Erath,17,756,338,418,329,408,4,0,2,2,0,2,0,0,3,6,327,395,11,23
Erath,18,773,274,499,266,487,0,0,5,4,0,0,0,1,3,7,256,477,18,22
Falls,5,1113,576,537,364,317,180,190,13,4,6,8,0,3,13,15,384,384,192,153
Falls,6,1280,579,701,383,422,175,245,7,6,4,8,4,3,6,17,388,511,191,190
Falls,7,1220,532,688,402,475,110,194,8,7,3,4,0,1,9,7,356,506,176,182
Falls,8,1125,465,660,345,446,105,196,5,5,1,5,1,0,8,8,324,514,141,146
Falls,9,954,397,557,306,398,75,142,5,6,4,6,1,1,6,4,278,440,119,117
Falls,10,1021,454,567,336,382,104,175,6,4,1,2,0,1,7,3,346,451,108,116
Falls,11,1148,538,610,398,424,128,168,3,4,6,4,0,1,3,9,403,497,135,113
Falls,12,1203,555,648,440,491,100,141,6,10,2,2,0,0,7,4,452,563,103,85
Falls,13,1106,562,544,422,408,125,116,7,10,1,2,1,1,6,7,495,459,67,85
Falls,14,971,485,486,392,386,79,92,6,4,5,0,0,3,3,1,432,437,53,49
Falls,15,747,355,392,298,302,43,79,7,4,0,2,1,0,6,5,310,355,45,37
Falls,16,591,282,309,225,248,46,53,2,3,1,2,0,0,8,3,255,286,27,23
Falls,17,422,191,231,165,175,23,48,2,4,1,2,0,1,0,1,174,211,17,20
Falls,18,400,173,227,146,175,23,49,3,2,0,1,0,0,1,0,157,207,16,20
Fannin,5,2119,1289,830,1030,737,192,39,27,17,11,9,0,0,29,28,1037,694,252,136
Fannin,6,2384,1403,981,1123,872,212,58,21,14,5,9,2,1,40,27,1124,854,279,127
Fannin,7,2128,1227,901,1022,806,168,49,7,20,6,9,3,1,21,16,978,791,249,110
Fannin,8,2246,1273,973,1092,894,150,38,14,18,6,9,0,0,11,14,1059,855,214,118
Fannin,9,2103,1140,963,979,869,126,37,14,12,5,27,0,0,16,18,956,838,184,125
Fannin,10,2299,1221,1078,1045,955,120,52,21,28,17,27,4,0,14,16,1087,986,134,92
Fannin,11,2313,1259,1054,1085,965,125,44,13,18,19,9,1,0,16,18,1128,993,131,61
Fannin,12,2515,1258,1257,1129,1169,96,42,12,13,3,8,1,3,17,22,1168,1202,90,55
Fannin,13,2326,1199,1127,1094,1035,67,51,13,18,2,4,1,0,22,19,1142,1082,57,45
Fannin,14,2015,986,1029,909,966,43,43,15,10,5,3,0,1,14,6,954,991,32,38
Fannin,15,1697,832,865,776,822,29,21,9,5,2,4,1,0,15,13,810,845,22,20
Fannin,16,1207,551,656,517,614,22,28,5,5,0,0,0,0,7,9,546,643,5,13
Fannin,17,852,419,433,390,413,20,11,4,2,0,2,0,0,5,5,411,423,8,10
Fannin,18,731,303,428,291,404,5,17,3,4,1,0,0,0,3,3,297,415,6,13
Fayette,5,1281,663,618,582,533,59,56,9,17,5,2,0,2,8,8,458,432,205,186
Fayette,6,1229,620,609,538,529,63,53,8,12,3,4,0,0,8,11,477,427,143,182
Fayette,7,1176,556,620,494,550,48,50,7,7,2,4,0,2,5,7,376,438,180,182
Fayette,8,1389,690,699,635,645,42,38,8,7,3,2,1,0,1,7,488,477,202,222
Fayette,9,1269,638,631,558,557,47,47,19,10,5,10,2,1,7,6,446,467,192,164
Fayette,10,1336,691,645,635,575,38,43,6,14,6,4,0,1,6,8,527,508,164,137
Fayette,11,1516,736,780,663,708,49,53,17,9,1,6,0,1,6,3,575,642,161,138
Fayette,12,2015,960,1055,895,973,52,59,8,6,4,8,0,1,1,8,824,925,136,130
Fayette,13,2050,1037,1013,963,937,55,57,12,5,4,3,1,0,2,11,918,911,119,102
Fayette,14,1917,944,973,888,910,45,54,6,2,0,1,0,0,5,6,859,902,85,71
Fayette,15,1573,792,781,760,755,23,17,4,5,0,1,0,1,5,2,736,735,56,46
Fayette,16,1202,575,627,545,597,22,24,4,1,2,0,0,0,2,5,547,598,28,29
Fayette,17,802,376,426,361,409,14,15,0,0,0,1,0,0,1,1,355,406,21,20
Fayette,18,916,323,593,306,551,9,35,2,3,1,1,0,0,5,3,308,568,15,25
Fisher,5,185,94,91,86,76,7,5,0,0,0,1,0,1,1,8,66,45,28,46
Fisher,6,214,109,105,95,92,10,8,0,1,0,0,0,0,4,4,74,75,35,30
Fisher,7,208,104,104,97,99,4,2,2,1,0,1,0,0,1,1,72,72,32,32
Fisher,8,188,99,89,93,79,3,2,0,4,1,3,0,0,2,1,71,58,28,31
Fisher,9,181,87,94,79,85,2,5,2,1,0,0,0,0,4,3,54,67,33,27
Fisher,10,218,108,110,100,100,4,7,1,0,0,0,2,1,1,2,77,82,31,28
Fisher,11,226,123,103,109,95,10,5,1,0,0,0,0,0,3,3,84,73,39,30
Fisher,12,272,144,128,132,120,6,4,1,2,2,2,0,0,3,0,116,88,28,40
Fisher,13,288,141,147,130,143,5,1,3,3,1,0,0,0,2,0,107,112,34,35
Fisher,14,273,128,145,123,142,1,1,2,1,0,0,0,0,2,1,97,110,31,35
Fisher,15,199,113,86,106,80,3,4,2,1,0,0,0,0,2,1,96,73,17,13
Fisher,16,169,61,108,55,101,4,3,2,3,0,0,0,0,0,1,45,93,16,15
Fisher,17,166,76,90,74,86,0,3,0,0,0,0,1,0,1,1,68,69,8,21
Fisher,18,142,57,85,56,73,0,7,1,3,0,0,0,0,0,2,51,65,6,20
Floyd,5,354,172,182,153,161,11,6,3,1,2,2,0,0,3,12,48,43,124,139
Floyd,6,344,169,175,148,158,10,6,3,2,1,0,0,0,7,9,62,49,107,126
Floyd,7,289,156,133,129,127,3,3,9,2,1,0,0,0,14,1,48,47,108,86
Floyd,8,354,171,183,163,173,6,4,2,4,0,0,0,0,0,2,66,58,105,125
Floyd,9,298,148,150,131,142,4,6,3,1,3,1,0,0,7,0,52,49,96,101
Floyd,10,333,173,160,155,149,7,3,3,5,3,1,0,1,5,1,62,64,111,96
Floyd,11,315,161,154,149,144,8,7,3,3,0,0,0,0,1,0,89,73,72,81
Floyd,12,366,166,200,159,185,5,12,1,2,1,1,0,0,0,0,81,112,85,88
Floyd,13,333,182,151,174,139,4,9,3,2,1,1,0,0,0,0,105,86,77,65
Floyd,14,306,151,155,140,145,5,6,3,2,1,1,0,0,2,1,91,89,60,66
Floyd,15,240,113,127,106,122,5,3,1,0,0,1,0,0,1,1,68,84,45,43
Floyd,16,231,102,129,97,122,2,4,2,2,1,0,0,0,0,1,75,91,27,38
Floyd,17,149,62,87,55,85,6,2,1,0,0,0,0,0,0,0,46,66,16,21
Floyd,18,155,71,84,70,74,0,9,1,0,0,0,0,0,0,1,44,75,27,9
Foard,5,62,27,35,25,29,1,6,0,0,0,0,0,0,1,0,19,28,8,7
Foard,6,50,25,25,24,24,1,1,0,0,0,0,0,0,0,0,18,23,7,2
Foard,7,59,27,32,23,27,2,1,0,1,0,3,0,0,2,0,24,24,3,8
Foard,8,57,30,27,25,24,1,2,3,0,0,0,0,0,1,1,17,21,13,6
Foard,9,47,20,27,19,25,0,1,0,1,1,0,0,0,0,0,13,19,7,8
Foard,10,68,34,34,33,32,1,1,0,0,0,1,0,0,0,0,29,28,5,6
Foard,11,96,50,46,46,44,4,1,0,0,0,1,0,0,0,0,35,39,15,7
Foard,12,95,53,42,50,40,3,1,0,1,0,0,0,0,0,0,40,33,13,9
Foard,13,74,35,39,33,38,0,1,0,0,0,0,0,0,2,0,29,34,6,5
Foard,14,77,44,33,41,33,2,0,0,0,1,0,0,0,0,0,43,29,1,4
Foard,15,73,26,47,25,44,1,1,0,1,0,1,0,0,0,0,24,40,2,7
Foard,16,68,36,32,34,31,1,1,1,0,0,0,0,0,0,0,34,29,2,3
Foard,17,52,16,36,15,34,1,1,0,0,0,0,0,0,0,1,16,34,0,2
Foard,18,47,13,34,13,32,0,2,0,0,0,0,0,0,0,0,11,34,2,0
Fort,5,44847,22721,22126,12368,11790,5527,5403,142,173,4031,4183,14,18,639,559,15757,15330,6964,6796
Fort,6,44453,21880,22573,11971,11674,5203,5172,188,170,4045,5059,29,27,444,471,15350,16248,6530,6325
Fort,7,50332,23637,26695,13737,14021,4337,5712,163,155,4964,6332,16,41,420,434,16743,19760,6894,6935
Fort,8,60535,28796,31739,16089,16374,5508,6806,167,216,6559,7823,32,35,441,485,21168,23625,7628,8114
Fort,9,59971,29025,30946,15892,16088,5556,6564,168,131,6961,7609,27,28,421,526,21370,23170,7655,7776
Fort,10,59802,29315,30487,16262,15800,5868,7032,168,175,6640,7027,14,17,363,436,22262,23454,7053,7033
Fort,11,50822,25061,25761,14210,13892,5023,5941,149,144,5344,5460,32,26,303,298,19368,20191,5693,5570
Fort,12,48744,23782,24962,13808,13934,5165,5920,133,142,4403,4673,19,18,254,275,19432,20349,4350,4613
Fort,13,44239,21483,22756,12661,12761,4442,5374,117,81,3999,4315,16,21,248,204,18156,19089,3327,3667
Fort,14,34569,16426,18143,9518,9914,3224,4184,68,71,3435,3792,7,13,174,169,13971,15422,2455,2721
Fort,15,23565,11163,12402,6727,7332,1720,2461,47,38,2544,2434,3,8,122,129,9618,10594,1545,1808
Fort,16,13758,6372,7386,3907,4525,868,1248,27,18,1523,1515,2,8,45,72,5549,6281,823,1105
Fort,17,7890,3322,4568,2140,2931,375,728,12,23,768,831,1,3,26,52,2838,3762,484,806
Fort,18,7551,2722,4829,1908,3446,264,669,5,20,530,677,1,1,14,16,2293,4014,429,815
Franklin,5,537,263,274,232,239,7,18,9,2,8,3,0,0,7,12,202,201,61,73
Franklin,6,549,293,256,268,242,13,9,4,0,4,2,0,0,4,3,223,210,70,46
Franklin,7,623,299,324,271,296,15,16,7,7,2,4,0,0,4,1,236,277,63,47
Franklin,8,592,287,305,265,283,14,14,4,2,4,0,0,0,0,6,223,256,64,49
Franklin,9,538,271,267,244,242,13,10,9,4,4,7,0,0,1,4,215,234,56,33
Franklin,10,619,325,294,301,267,9,11,5,2,5,8,0,0,5,6,288,260,37,34
Franklin,11,671,314,357,293,332,10,11,2,7,5,4,0,0,4,3,264,308,50,49
Franklin,12,796,413,383,374,361,20,13,5,5,8,1,0,0,6,3,368,349,45,34
Franklin,13,740,377,363,358,341,14,14,3,1,0,3,1,1,1,3,349,345,28,18
Franklin,14,706,340,366,330,341,5,14,2,4,0,1,0,0,3,6,321,343,19,23
Franklin,15,625,294,331,284,316,6,7,0,2,1,0,0,1,3,5,274,321,20,10
Franklin,16,453,221,232,209,224,6,6,1,1,1,0,0,0,4,1,215,228,6,4
Franklin,17,289,137,152,128,144,8,6,0,0,0,2,0,0,1,0,133,150,4,2
Franklin,18,283,111,172,107,158,1,6,1,4,0,1,0,0,2,3,110,170,1,2
Freestone,5,902,470,432,364,329,77,76,9,11,7,8,0,0,13,8,379,331,91,101
Freestone,6,1028,578,450,458,357,97,69,11,7,4,11,0,0,8,6,437,388,141,62
Freestone,7,1175,648,527,504,439,124,70,7,5,7,6,0,1,6,6,499,421,149,106
Freestone,8,1287,730,557,548,432,147,95,12,11,7,2,0,0,16,17,553,458,177,99
Freestone,9,1343,782,561,602,471,149,67,13,8,7,4,0,0,11,11,624,460,158,101
Freestone,10,1326,758,568,576,465,158,75,9,12,4,12,2,0,9,4,631,489,127,79
Freestone,11,1194,638,556,496,460,120,79,13,5,5,6,0,0,4,6,527,507,111,49
Freestone,12,1291,696,595,539,487,125,94,17,5,7,4,0,1,8,4,625,549,71,46
Freestone,13,1322,652,670,496,542,135,116,11,6,3,2,0,0,7,4,601,633,51,37
Freestone,14,1216,594,622,500,513,82,98,6,3,1,3,0,0,5,5,558,601,36,21
Freestone,15,992,461,531,402,444,47,74,3,3,0,2,0,0,9,8,436,512,25,19
Freestone,16,731,354,377,291,337,54,34,0,0,2,1,0,0,7,5,345,370,9,7
Freestone,17,501,229,272,191,217,35,52,0,0,0,1,0,0,3,2,225,267,4,5
Freestone,18,482,169,313,142,257,23,52,1,2,0,0,1,0,2,2,163,305,6,8
Frio,5,2042,1517,525,1228,502,176,7,17,5,89,3,1,0,6,8,326,72,1191,453
Frio,6,2129,1561,568,1257,522,154,30,26,6,105,7,0,1,19,2,377,83,1184,485
Frio,7,1759,1285,474,1031,460,138,5,14,0,93,6,0,1,9,2,310,76,975,398
Frio,8,1396,912,484,776,457,71,11,12,4,46,6,1,0,6,6,198,86,714,398
Frio,9,1144,689,455,601,433,32,7,6,10,35,4,0,0,15,1,143,76,546,379
Frio,10,1046,602,444,526,425,29,7,6,3,31,6,0,0,10,3,148,90,454,354
Frio,11,1066,581,485,541,469,13,6,10,4,12,4,0,0,5,2,113,95,468,390
Frio,12,927,492,435,458,415,13,5,9,8,6,5,0,0,6,2,148,110,344,325
Frio,13,839,423,416,408,403,5,3,6,2,2,2,0,1,2,5,127,114,296,302
Frio,14,783,371,412,360,400,1,4,2,3,4,2,0,0,4,3,101,108,270,304
Frio,15,654,311,343,309,340,0,3,1,0,0,0,0,0,1,0,95,91,216,252
Frio,16,422,187,235,178,227,5,2,1,0,2,2,0,1,1,3,60,80,127,155
Frio,17,314,128,186,127,183,0,1,0,1,1,1,0,0,0,0,43,43,85,143
Frio,18,273,85,188,80,184,1,1,0,1,0,1,0,0,4,1,28,50,57,138
Gaines,5,1345,689,656,638,620,25,12,11,10,6,3,1,2,8,9,372,357,317,299
Gaines,6,1408,741,667,684,636,23,12,18,5,3,4,0,0,13,10,401,398,340,269
Gaines,7,1446,764,682,727,648,28,14,5,6,1,6,0,0,3,8,432,397,332,285
Gaines,8,1307,677,630,627,601,37,12,4,7,3,4,2,0,4,6,402,361,275,269
Gaines,9,1220,624,596,593,576,12,11,12,3,2,2,0,0,5,4,342,340,282,256
Gaines,10,1055,530,525,509,498,7,13,7,7,3,2,0,0,4,5,322,336,208,189
Gaines,11,1056,556,500,527,476,9,13,7,6,3,3,0,0,10,2,339,315,217,185
Gaines,12,1164,583,581,549,558,10,12,9,6,8,3,0,0,7,2,357,384,226,197
Gaines,13,861,467,394,444,369,8,11,3,9,3,2,2,0,7,3,261,239,206,155
Gaines,14,616,297,319,288,309,6,4,3,1,0,1,0,0,0,4,175,199,122,120
Gaines,15,457,222,235,209,225,1,3,6,5,2,0,1,0,3,2,153,139,69,96
Gaines,16,304,130,174,123,163,3,6,2,2,0,0,0,0,2,3,74,122,56,52
Gaines,17,284,132,152,125,142,3,7,1,0,0,0,0,0,3,3,86,114,46,38
Gaines,18,218,87,131,82,125,2,1,2,3,0,0,0,0,1,2,68,113,19,18
Galveston,5,19835,10131,9704,7958,7520,1492,1424,94,89,306,396,15,17,266,258,6924,6595,3207,3109
Galveston,6,22590,11206,11384,8864,8812,1651,1766,111,113,350,452,12,15,218,226,7963,8207,3243,3177
Galveston,7,22665,11095,11570,8978,9177,1414,1591,92,98,424,500,11,14,176,190,7842,8430,3253,3140
Galveston,8,23153,11372,11781,9285,9269,1397,1712,113,76,399,532,17,10,161,182,8057,8659,3315,3122
Galveston,9,21246,10340,10906,8402,8573,1232,1502,83,123,431,535,12,16,180,157,7326,7995,3014,2911
Galveston,10,22039,10749,11290,8875,9268,1217,1245,94,121,424,486,13,13,126,157,8144,8541,2605,2749
Galveston,11,21796,10533,11263,8658,9104,1259,1449,81,111,410,450,11,8,114,141,8360,8948,2173,2315
Galveston,12,23854,11610,12244,9696,10006,1348,1605,97,107,334,411,9,7,126,108,9611,10220,1999,2024
Galveston,13,21516,10612,10904,8848,8898,1193,1500,84,76,351,313,16,14,120,103,8983,9303,1629,1601
Galveston,14,17283,8276,9007,6961,7333,951,1248,60,51,209,281,5,8,90,86,7087,7768,1189,1239
Galveston,15,12756,6095,6661,5200,5489,615,828,39,31,186,260,4,1,51,52,5355,5862,740,799
Galveston,16,8203,3658,4545,3143,3770,351,567,19,28,109,125,0,5,36,50,3214,3956,444,589
Galveston,17,5276,2178,3098,1833,2512,238,458,18,23,70,77,0,3,19,25,1883,2688,295,410
Galveston,18,5146,1852,3294,1574,2709,200,486,15,22,44,46,3,2,16,29,1593,2883,259,411
Garza,5,628,509,119,459,100,41,10,2,3,0,1,1,1,6,4,153,56,356,63
Garza,6,771,585,186,526,160,53,20,0,3,1,2,0,0,5,1,190,93,395,93
Garza,7,517,372,145,333,122,37,15,0,1,0,4,1,0,1,3,138,84,234,61
Garza,8,356,239,117,225,96,10,10,3,3,0,7,0,1,1,0,70,65,169,52
Garza,9,380,241,139,212,125,21,9,0,2,1,0,0,0,7,3,92,75,149,64
Garza,10,523,367,156,326,145,19,8,6,0,16,3,0,0,0,0,139,90,228,66
Garza,11,338,206,132,182,118,11,6,4,4,5,2,0,0,4,2,87,80,119,52
Garza,12,442,300,142,279,129,17,11,0,2,1,0,0,0,3,0,151,99,149,43
Garza,13,257,149,108,141,97,7,10,0,0,1,1,0,0,0,0,112,80,37,28
Garza,14,186,70,116,63,109,5,6,1,1,0,0,0,0,1,0,54,89,16,27
Garza,15,175,79,96,74,92,3,3,1,1,1,0,0,0,0,0,69,68,10,28
Garza,16,143,67,76,65,72,0,3,1,0,0,0,0,0,1,1,56,64,11,12
Garza,17,122,66,56,65,54,1,2,0,0,0,0,0,0,0,0,56,46,10,10
Garza,18,91,34,57,32,56,1,0,1,1,0,0,0,0,0,0,26,48,8,9
Gillespie,5,1238,635,603,603,569,6,3,11,17,4,2,0,1,11,11,353,388,282,215
Gillespie,6,1173,593,580,554,548,17,8,13,7,3,7,0,3,6,7,353,373,240,207
Gillespie,7,1176,590,586,550,561,9,3,16,6,3,6,1,2,11,8,390,418,200,168
Gillespie,8,1322,649,673,609,653,16,5,7,7,10,5,1,2,6,1,431,445,218,228
Gillespie,9,1197,561,636,535,607,3,2,13,13,3,7,2,1,5,6,378,432,183,204
Gillespie,10,1350,651,699,631,680,1,1,10,9,3,3,0,1,6,5,478,523,173,176
Gillespie,11,1454,703,751,668,729,12,5,11,6,3,4,3,0,6,7,528,593,175,158
Gillespie,12,1914,901,1013,867,985,6,4,16,12,8,6,1,0,3,6,732,846,169,167
Gillespie,13,2090,954,1136,922,1106,8,6,15,12,2,2,1,1,6,9,834,995,120,141
Gillespie,14,2190,1030,1160,1006,1130,1,4,8,13,3,4,1,2,11,7,940,1066,90,94
Gillespie,15,1987,954,1033,937,1017,1,3,5,4,3,3,1,0,7,6,879,966,75,67
Gillespie,16,1568,766,802,754,794,2,2,2,3,1,1,1,0,6,2,711,760,55,42
Gillespie,17,1074,539,535,531,529,2,1,2,2,1,3,0,0,3,0,523,513,16,22
Gillespie,18,1137,440,697,434,684,0,5,2,5,0,1,0,0,4,2,419,671,21,26
Glasscock,5,89,53,36,50,32,3,4,0,0,0,0,0,0,0,0,34,21,19,15
Glasscock,6,93,53,40,52,38,1,1,0,0,0,0,0,0,0,1,24,31,29,9
Glasscock,7,81,59,22,56,21,2,1,1,0,0,0,0,0,0,0,26,14,33,8
Glasscock,8,100,49,51,47,49,2,0,0,0,0,1,0,1,0,0,24,28,25,23
Glasscock,9,88,48,40,45,40,0,0,0,0,1,0,0,0,2,0,25,24,23,16
Glasscock,10,95,51,44,51,40,0,4,0,0,0,0,0,0,0,0,31,28,20,16
Glasscock,11,77,42,35,41,34,1,0,0,0,0,0,0,0,0,1,28,22,14,13
Glasscock,12,88,44,44,42,44,1,0,1,0,0,0,0,0,0,0,34,34,10,10
Glasscock,13,78,43,35,42,35,0,0,0,0,0,0,0,0,1,0,33,30,10,5
Glasscock,14,73,41,32,41,32,0,0,0,0,0,0,0,0,0,0,25,21,16,11
Glasscock,15,46,27,19,25,19,0,0,2,0,0,0,0,0,0,0,14,17,13,2
Glasscock,16,40,19,21,18,21,0,0,1,0,0,0,0,0,0,0,17,17,2,4
Glasscock,17,34,17,17,17,17,0,0,0,0,0,0,0,0,0,0,15,15,2,2
Glasscock,18,19,8,11,8,11,0,0,0,0,0,0,0,0,0,0,6,11,2,0
Goliad,5,376,201,175,171,163,17,7,4,0,3,1,0,0,6,4,105,88,96,87
Goliad,6,380,195,185,178,171,10,8,1,3,1,1,0,0,5,2,110,93,85,92
Goliad,7,395,195,200,169,182,17,12,3,3,5,1,0,0,1,2,115,121,80,79
Goliad,8,415,212,203,195,191,12,6,1,2,3,3,0,0,1,1,128,126,84,77
Goliad,9,402,189,213,169,201,17,9,1,0,0,0,0,0,2,3,120,132,69,81
Goliad,10,442,223,219,203,202,10,11,6,3,1,1,0,1,3,1,142,127,81,92
Goliad,11,464,222,242,204,227,10,8,4,2,1,2,0,0,3,3,155,170,67,72
Goliad,12,563,275,288,253,268,14,12,2,5,0,2,1,0,5,1,195,206,80,82
Goliad,13,616,300,316,283,294,8,17,2,3,2,2,0,0,5,0,217,243,83,73
Goliad,14,570,286,284,270,271,13,11,1,2,0,0,0,0,2,0,217,214,69,70
Goliad,15,451,227,224,212,210,9,8,3,3,1,1,0,0,2,2,174,168,53,56
Goliad,16,306,137,169,130,159,7,8,0,0,0,1,0,0,0,1,105,123,32,46
Goliad,17,202,95,107,94,103,0,3,1,1,0,0,0,0,0,0,73,69,22,38
Goliad,18,234,90,144,86,134,2,9,1,0,0,1,0,0,1,0,61,103,29,41
Gonzales,5,1194,658,536,568,476,56,37,19,12,2,4,2,0,11,7,268,226,390,310
Gonzales,6,1316,671,645,583,578,62,36,16,13,4,6,0,2,6,10,297,272,374,373
Gonzales,7,1215,591,624,493,559,74,43,12,7,3,8,3,0,6,7,253,247,338,377
Gonzales,8,1201,614,587,552,520,45,42,6,14,5,5,2,1,4,5,270,269,344,318
Gonzales,9,1111,554,557,490,498,41,32,14,14,7,5,2,0,0,8,217,238,337,319
Gonzales,10,1194,561,633,511,568,26,36,16,16,2,5,0,0,6,8,275,316,286,317
Gonzales,11,1195,610,585,544,513,44,48,16,16,1,5,0,1,5,2,315,314,295,271
Gonzales,12,1398,699,699,631,619,40,61,19,12,5,3,1,0,3,4,392,440,307,259
Gonzales,13,1300,669,631,601,568,52,41,11,9,1,3,0,3,4,7,424,431,245,200
Gonzales,14,1037,538,499,489,456,42,35,1,3,1,1,1,1,4,3,378,370,160,129
Gonzales,15,872,405,467,374,440,20,17,6,3,2,4,0,0,3,3,293,327,112,140
Gonzales,16,696,330,366,312,339,14,26,3,0,0,0,1,0,0,1,246,289,84,77
Gonzales,17,471,208,263,190,244,13,16,3,1,0,2,0,0,2,0,153,196,55,67
Gonzales,18,412,161,251,139,231,19,19,1,1,0,0,0,0,2,0,132,202,29,49
Gray,5,1198,655,543,593,496,41,18,3,7,5,0,0,0,13,22,404,330,251,213
Gray,6,1532,903,629,762,580,110,16,16,15,6,4,0,0,9,14,556,411,347,218
Gray,7,1449,808,641,695,592,85,14,15,12,5,12,0,0,8,11,541,428,267,213
Gray,8,1528,874,654,752,615,98,16,15,9,4,7,0,0,5,7,559,459,315,195
Gray,9,1389,833,556,690,525,114,15,8,10,4,1,0,0,17,5,573,379,260,177
Gray,10,1416,862,554,713,524,125,11,13,4,3,4,0,0,8,11,610,422,252,132
Gray,11,1276,758,518,644,486,92,9,10,11,1,5,0,0,11,7,556,399,202,119
Gray,12,1397,731,666,635,622,75,11,9,16,4,4,0,0,8,13,599,542,132,124
Gray,13,1234,620,614,573,581,31,13,9,9,2,3,0,0,5,8,490,530,130,84
Gray,14,1058,537,521,508,482,18,23,4,7,4,2,0,0,3,7,457,459,80,62
Gray,15,848,394,454,359,421,18,11,8,8,1,7,0,0,8,7,356,409,38,45
Gray,16,684,303,381,277,367,12,5,10,4,1,2,0,0,3,3,279,354,24,27
Gray,17,459,187,272,181,256,2,4,1,4,0,1,1,0,2,7,180,254,7,18
Gray,18,489,196,293,190,284,3,6,1,2,1,0,0,0,1,1,184,287,12,6
Grayson,5,7874,3989,3885,3311,3242,313,323,81,80,136,96,2,10,146,134,3266,3161,723,724
Grayson,6,8612,4267,4345,3567,3711,369,337,92,84,123,86,2,7,114,120,3569,3681,698,664
Grayson,7,7992,3892,4100,3333,3575,317,281,67,84,88,70,3,2,84,88,3167,3459,725,641
Grayson,8,8169,3998,4171,3533,3610,257,280,74,89,76,97,2,2,56,93,3297,3562,701,609
Grayson,9,7380,3629,3751,3223,3321,213,208,81,80,54,65,7,2,51,75,3064,3203,565,548
Grayson,10,8108,3945,4163,3557,3718,194,233,62,89,51,52,2,4,79,67,3395,3699,550,464
Grayson,11,8348,4054,4294,3630,3851,231,247,79,84,45,43,7,5,62,64,3575,3872,479,422
Grayson,12,9417,4552,4865,4135,4395,263,277,76,85,34,42,1,4,43,62,4171,4517,381,348
Grayson,13,9138,4356,4782,3910,4299,260,287,79,78,41,59,1,2,65,57,4107,4530,249,252
Grayson,14,7475,3536,3939,3248,3614,194,188,54,57,11,33,1,1,28,46,3333,3759,203,180
Grayson,15,6315,2970,3345,2765,3072,127,145,45,53,9,32,2,2,22,41,2882,3244,88,101
Grayson,16,4268,1968,2300,1852,2150,71,94,15,19,11,15,0,1,19,21,1909,2238,59,62
Grayson,17,2727,1150,1577,1092,1474,28,64,12,15,5,12,0,0,13,12,1118,1544,32,33
Grayson,18,2712,971,1741,928,1659,18,59,14,17,1,4,0,0,10,2,934,1702,37,39
Gregg,5,8232,4164,4068,2998,2843,953,1019,46,44,49,54,6,4,112,104,3251,3210,913,858
Gregg,6,8794,4307,4487,3111,3221,984,1053,54,48,82,82,7,5,69,78,3426,3516,881,971
Gregg,7,8042,3953,4089,3010,2950,749,938,45,44,75,91,11,3,63,63,3011,3299,942,790
Gregg,8,7904,3946,3958,2983,2835,792,938,41,31,70,86,2,3,58,65,3055,3233,891,725
Gregg,9,6909,3418,3491,2607,2509,663,838,37,42,54,61,6,5,51,36,2672,2855,746,636
Gregg,10,7214,3409,3805,2582,2765,687,886,49,33,55,70,9,6,27,45,2705,3207,704,598
Gregg,11,6954,3355,3599,2563,2665,652,812,39,35,51,49,8,6,42,32,2758,3161,597,438
Gregg,12,7728,3669,4059,2769,3000,758,915,56,40,42,60,5,2,39,42,3177,3685,492,374
Gregg,13,7369,3540,3829,2771,2931,668,799,37,35,35,37,0,1,29,26,3217,3594,323,235
Gregg,14,5947,2768,3179,2234,2499,456,593,27,24,26,36,2,1,23,26,2585,3002,183,177
Gregg,15,4627,2045,2582,1695,2099,304,420,12,17,17,32,1,0,16,14,1962,2472,83,110
Gregg,16,3369,1414,1955,1172,1660,199,266,10,10,12,8,2,1,19,10,1362,1886,52,69
Gregg,17,2452,950,1502,800,1286,137,190,3,6,4,6,0,0,6,14,912,1441,38,61
Gregg,18,2624,901,1723,802,1488,83,198,6,7,4,8,0,0,6,22,860,1685,41,38
Grimes,5,1621,986,635,701,504,238,101,22,8,4,6,0,0,21,16,677,414,309,221
Grimes,6,1884,1152,732,853,609,266,97,8,6,2,5,3,3,20,12,841,519,311,213
Grimes,7,1760,1005,755,770,623,211,102,7,17,4,3,1,0,12,10,745,553,260,202
Grimes,8,1745,1000,745,787,614,199,107,4,6,1,6,1,0,8,12,736,526,264,219
Grimes,9,1686,968,718,763,600,182,103,15,2,1,6,1,0,6,7,700,501,268,217
Grimes,10,1800,1064,736,853,615,184,92,13,15,4,5,0,1,10,8,814,560,250,176
Grimes,11,1894,1050,844,830,667,197,144,4,8,9,8,2,2,8,15,820,664,230,180
Grimes,12,2063,1108,955,885,809,194,128,11,4,2,3,1,0,15,11,941,827,167,128
Grimes,13,1982,1047,935,865,791,156,116,12,9,2,5,0,0,12,14,881,841,166,94
Grimes,14,1665,882,783,760,659,105,112,7,8,1,0,3,0,6,4,766,710,116,73
Grimes,15,1357,693,664,616,587,68,62,5,7,1,0,0,1,3,7,624,598,69,66
Grimes,16,869,447,422,403,369,31,45,5,1,1,1,0,0,7,6,402,377,45,45
Grimes,17,517,234,283,200,243,31,34,0,1,1,0,0,0,2,5,207,263,27,20
Grimes,18,507,178,329,159,267,17,46,0,3,0,2,0,3,2,8,174,311,4,18
Guadalupe,5,9921,5108,4813,4270,4020,501,448,40,53,92,104,10,9,195,179,2752,2540,2356,2273
Guadalupe,6,9955,4960,4995,4224,4283,420,377,60,58,103,134,13,17,140,126,2795,2817,2165,2178
Guadalupe,7,11143,5605,5538,4877,4853,460,357,52,57,86,126,12,10,118,135,3178,3202,2427,2336
Guadalupe,8,12175,6132,6043,5233,5159,590,505,58,69,108,150,13,16,130,144,3587,3551,2545,2492
Guadalupe,9,11114,5521,5593,4682,4737,568,516,62,54,85,135,10,22,114,129,3350,3335,2171,2258
Guadalupe,10,11145,5534,5611,4693,4739,609,525,60,44,88,181,10,12,74,110,3518,3550,2016,2061
Guadalupe,11,10597,5303,5294,4429,4445,630,592,54,41,91,136,14,12,85,68,3639,3556,1664,1738
Guadalupe,12,10353,5014,5339,4264,4532,533,506,51,42,96,172,15,9,55,78,3543,3727,1471,1612
Guadalupe,13,8792,4145,4647,3616,4017,388,392,38,47,44,131,9,10,50,50,2994,3417,1151,1230
Guadalupe,14,7474,3537,3937,3172,3485,266,250,28,31,37,119,4,7,30,45,2601,2855,936,1082
Guadalupe,15,6062,2874,3188,2649,2857,151,198,16,29,18,79,4,5,36,20,2151,2383,723,805
Guadalupe,16,4055,1842,2213,1693,1984,96,138,19,18,16,56,3,1,15,16,1454,1717,388,496
Guadalupe,17,2633,1121,1512,1027,1391,66,72,9,14,9,25,0,2,10,8,860,1145,261,367
Guadalupe,18,2407,910,1497,845,1369,36,75,9,16,11,23,2,0,7,14,722,1175,188,322
Hale,5,2692,1592,1100,1341,991,192,58,16,27,24,7,2,3,17,14,674,390,918,710
Hale,6,2427,1396,1031,1185,945,174,49,18,14,10,7,3,0,6,16,554,343,842,688
Hale,7,2289,1290,999,1115,928,120,35,17,26,10,0,2,3,26,7,519,335,771,664
Hale,8,2174,1171,1003,1039,927,92,37,19,26,9,6,4,2,8,5,433,333,738,670
Hale,9,1814,956,858,843,787,72,40,30,16,4,8,0,1,7,6,353,292,603,566
Hale,10,1913,1018,895,920,813,55,46,20,15,4,11,1,2,18,8,430,338,588,557
Hale,11,1915,1000,915,893,843,78,35,12,17,6,8,3,1,8,11,472,405,528,510
Hale,12,1896,961,935,880,867,44,45,19,15,8,2,1,1,9,5,500,441,461,494
Hale,13,1771,867,904,795,844,49,36,17,17,4,2,0,0,2,5,442,476,425,428
Hale,14,1382,687,695,637,641,29,32,12,11,2,4,1,1,6,6,373,421,314,274
Hale,15,1093,522,571,498,528,9,21,6,10,1,4,0,0,8,8,309,353,213,218
Hale,16,863,380,483,355,451,15,21,4,4,2,1,1,0,3,6,258,316,122,167
Hale,17,584,247,337,230,313,6,10,4,6,3,5,0,0,4,3,169,233,78,104
Hale,18,596,245,351,225,331,12,12,4,3,0,3,0,2,4,0,171,274,74,77
Hall,5,166,87,79,76,69,7,9,1,0,1,1,0,0,2,0,54,46,33,33
Hall,6,169,92,77,74,63,13,7,2,2,0,0,1,1,2,4,51,48,41,29
Hall,7,131,67,64,52,56,9,6,3,0,1,0,0,0,2,2,30,25,37,39
Hall,8,164,79,85,73,75,6,5,0,3,0,0,0,0,0,2,46,42,33,43
Hall,9,142,55,87,46,77,6,6,3,2,0,0,0,0,0,2,39,53,16,34
Hall,10,164,73,91,64,84,7,6,2,1,0,0,0,0,0,0,45,55,28,36
Hall,11,182,100,82,90,70,10,10,0,0,0,1,0,0,0,1,70,58,30,24
Hall,12,217,110,107,95,96,12,7,1,1,2,1,0,0,0,2,82,82,28,25
Hall,13,212,106,106,97,99,8,5,0,2,0,0,0,0,1,0,77,83,29,23
Hall,14,183,81,102,70,90,8,9,3,1,0,0,0,0,0,2,65,86,16,16
Hall,15,169,84,85,77,76,6,7,1,2,0,0,0,0,0,0,72,74,12,11
Hall,16,146,69,77,59,69,7,6,1,0,1,1,0,0,1,1,63,71,6,6
Hall,17,106,49,57,43,52,5,1,0,2,0,0,0,0,1,2,45,51,4,6
Hall,18,100,47,53,42,47,4,5,0,0,0,0,0,0,1,1,37,47,10,6
Hamilton,5,399,223,176,197,167,6,1,12,2,4,2,0,0,4,4,167,135,56,41
Hamilton,6,491,241,250,216,232,9,5,9,9,2,2,0,0,5,2,200,209,41,41
Hamilton,7,455,244,211,231,197,4,3,3,5,2,4,2,1,2,1,194,186,50,25
Hamilton,8,421,225,196,217,185,1,4,2,2,2,3,0,0,3,2,198,168,27,28
Hamilton,9,420,207,213,196,198,0,5,7,3,1,3,0,0,3,4,182,178,25,35
Hamilton,10,441,211,230,196,218,4,1,4,5,1,1,1,0,5,5,175,200,36,30
Hamilton,11,467,239,228,227,218,1,1,8,8,1,0,0,0,2,1,200,198,39,30
Hamilton,12,628,305,323,288,304,7,2,5,7,3,6,0,0,2,4,282,297,23,26
Hamilton,13,600,296,304,286,296,0,1,7,4,3,1,0,0,0,2,273,280,23,24
Hamilton,14,572,281,291,272,283,3,0,2,4,1,3,0,0,3,1,265,279,16,12
Hamilton,15,492,224,268,220,258,0,0,3,4,1,2,0,0,0,4,212,260,12,8
Hamilton,16,423,209,214,203,211,0,0,3,1,2,0,0,0,1,2,206,206,3,8
Hamilton,17,286,133,153,131,152,0,0,1,1,1,0,0,0,0,0,130,150,3,3
Hamilton,18,344,122,222,121,220,0,0,0,1,0,1,0,0,1,0,119,219,3,3
Hansford,5,315,151,164,140,154,1,2,4,2,1,4,0,0,5,2,54,74,97,90
Hansford,6,378,194,184,185,179,3,0,1,3,0,0,0,0,5,2,76,80,118,104
Hansford,7,304,170,134,159,128,2,1,6,2,1,1,1,1,1,1,77,70,93,64
Hansford,8,289,131,158,122,149,3,2,4,4,2,2,0,0,0,1,65,81,66,77
Hansford,9,322,159,163,152,153,2,2,2,6,2,0,0,0,1,2,88,83,71,80
Hansford,10,307,163,144,157,142,1,0,5,1,0,0,0,0,0,1,80,78,83,66
Hansford,11,325,172,153,165,144,0,1,4,6,0,1,0,0,3,1,82,91,90,62
Hansford,12,335,181,154,173,150,5,2,2,2,0,0,0,0,1,0,96,90,85,64
Hansford,13,297,152,145,149,138,0,0,1,3,0,0,0,0,2,4,101,104,51,41
Hansford,14,241,126,115,121,111,3,1,2,3,0,0,0,0,0,0,98,87,28,28
Hansford,15,178,83,95,79,91,1,1,2,3,0,0,0,0,1,0,57,77,26,18
Hansford,16,147,65,82,65,79,0,1,0,1,0,0,0,0,0,1,53,72,12,10
Hansford,17,115,43,72,42,69,0,1,1,1,0,0,0,0,0,1,38,64,5,8
Hansford,18,121,32,89,30,87,0,1,1,0,0,0,0,0,1,1,29,82,3,7
Hardeman,5,207,119,88,99,80,12,4,1,0,1,1,0,0,6,3,82,60,37,28
Hardeman,6,210,96,114,79,104,14,6,0,0,0,0,0,0,3,4,60,68,36,46
Hardeman,7,211,117,94,105,79,7,8,1,3,0,1,0,0,4,3,88,62,29,32
Hardeman,8,241,119,122,108,109,7,6,3,4,0,0,0,0,1,3,82,78,37,44
Hardeman,9,220,104,116,91,104,10,4,3,2,0,4,0,0,0,2,78,90,26,26
Hardeman,10,256,135,121,117,109,10,9,4,1,1,0,0,0,3,2,112,96,23,25
Hardeman,11,238,116,122,104,112,7,7,0,1,2,1,0,0,3,1,87,101,29,21
Hardeman,12,246,122,124,116,113,4,9,0,1,0,0,0,0,2,1,104,109,18,15
Hardeman,13,291,144,147,134,138,6,8,2,1,2,0,0,0,0,0,122,127,22,20
Hardeman,14,269,139,130,129,120,6,6,2,0,1,3,0,0,1,1,123,114,16,16
Hardeman,15,213,82,131,75,120,5,7,0,0,1,1,0,0,1,3,76,114,6,17
Hardeman,16,175,91,84,88,76,2,6,0,1,0,0,0,0,1,1,82,76,9,8
Hardeman,17,113,54,59,52,57,2,2,0,0,0,0,0,0,0,0,52,56,2,3
Hardeman,18,113,47,66,42,58,4,4,0,2,0,0,0,0,1,2,42,60,5,6
Hardin,5,3059,1583,1476,1419,1327,110,108,6,7,15,12,0,0,33,22,1456,1370,127,106
Hardin,6,3635,1829,1806,1636,1639,138,116,17,11,16,14,2,0,20,26,1682,1676,147,130
Hardin,7,3556,1733,1823,1608,1683,80,102,17,6,14,17,0,0,14,15,1586,1705,147,118
Hardin,8,3781,1905,1876,1773,1724,91,97,15,19,12,15,1,1,13,20,1742,1742,163,134
Hardin,9,3348,1611,1737,1501,1606,65,91,9,10,18,17,2,0,16,13,1500,1654,111,83
Hardin,10,3605,1798,1807,1677,1661,77,93,21,12,10,20,0,1,13,20,1688,1703,110,104
Hardin,11,3573,1759,1814,1643,1673,69,96,15,11,18,17,0,0,14,17,1668,1734,91,80
Hardin,12,3984,1969,2015,1831,1847,92,125,16,7,14,19,0,2,16,15,1905,1949,64,66
Hardin,13,3827,1867,1960,1722,1819,110,104,8,8,13,18,0,0,14,11,1788,1913,79,47
Hardin,14,3095,1473,1622,1370,1511,77,84,8,10,4,4,0,0,14,13,1428,1578,45,44
Hardin,15,2488,1151,1337,1084,1251,51,69,5,7,4,4,0,1,7,5,1125,1306,26,31
Hardin,16,1761,770,991,721,919,30,54,4,4,1,5,2,0,12,9,753,969,17,22
Hardin,17,1108,458,650,430,620,22,22,2,1,1,3,0,0,3,4,447,639,11,11
Hardin,18,1046,371,675,352,627,14,34,0,2,1,4,0,2,4,6,359,669,12,6
Harris,5,312710,157968,154742,109178,104158,32514,34419,2031,2095,10623,10401,198,199,3424,3470,78188,78503,79780,76239
Harris,6,381761,191835,189926,130575,122999,39990,44735,2333,2129,15084,15979,269,236,3584,3848,105521,109424,86314,80502
Harris,7,371427,188462,182965,132023,120285,35132,40899,2520,1845,15327,16456,274,264,3186,3216,103919,108183,84543,74782
Harris,8,354165,179307,174858,126761,117057,33405,37967,2410,1819,13804,14793,304,282,2623,2940,95901,99396,83406,75462
Harris,9,314866,158156,156710,113563,106810,27757,32299,2173,1735,12335,13173,203,244,2125,2449,81916,85677,76240,71033
Harris,10,306097,151801,154296,108652,104647,26778,32010,1853,1678,12416,13763,174,187,1928,2011,85110,90228,66691,64068
Harris,11,275961,136412,139549,98182,95748,24510,29217,1601,1439,10635,11482,131,152,1353,1511,80772,86111,55640,53438
Harris,12,267690,130980,136710,94885,94143,23502,29271,1344,1240,9748,10458,108,143,1393,1455,85449,92569,45531,44141
Harris,13,235552,113896,121656,82492,84219,20709,25794,1070,862,8517,9573,74,76,1034,1132,80703,87401,33193,34255
Harris,14,179887,84010,95877,60883,65962,14770,20033,626,646,6902,8387,40,40,789,809,62213,71830,21797,24047
Harris,15,128382,59086,69296,43679,49400,9468,13339,397,420,5042,5544,22,23,478,570,45579,53730,13507,15566
Harris,16,81910,35961,45949,26427,32984,5559,8631,200,271,3473,3759,7,20,295,284,28417,36194,7544,9755
Harris,17,51371,20889,30482,15628,22222,3011,5698,83,126,2028,2212,0,10,139,214,16294,23824,4595,6658
Harris,18,51007,18018,32989,13959,25126,2400,5453,89,140,1441,2072,5,5,124,193,14371,26597,3647,6392
Harrison,5,3960,2009,1951,1438,1297,483,569,30,24,13,14,4,3,41,44,1622,1617,387,334
Harrison,6,3989,1985,2004,1459,1482,454,455,16,24,18,9,5,2,33,32,1672,1684,313,320
Harrison,7,4012,1913,2099,1467,1579,377,429,14,31,24,30,5,2,26,28,1621,1822,292,277
Harrison,8,4181,2022,2159,1606,1608,357,467,16,29,16,30,5,2,22,23,1711,1885,311,274
Harrison,9,3733,1849,1884,1432,1415,341,385,32,37,16,25,5,2,23,20,1568,1628,281,256
Harrison,10,4084,2023,2061,1553,1573,399,421,35,21,22,20,0,3,14,23,1786,1852,237,209
Harrison,11,4007,1894,2113,1490,1575,357,472,22,29,17,17,1,2,7,18,1693,1957,201,156
Harrison,12,4497,2239,2258,1716,1656,461,552,27,25,10,9,3,2,22,14,2077,2139,162,119
Harrison,13,4347,2166,2181,1654,1643,452,483,26,16,14,11,0,2,20,26,2021,2077,145,104
Harrison,14,3700,1743,1957,1311,1458,387,450,23,16,6,13,2,2,14,18,1663,1897,80,60
Harrison,15,3010,1434,1576,1109,1189,293,361,12,8,5,8,0,1,15,9,1401,1528,33,48
Harrison,16,1988,938,1050,768,815,153,219,9,5,2,7,0,0,6,4,915,1029,23,21
Harrison,17,1341,547,794,448,613,88,166,0,2,5,7,0,0,6,6,534,772,13,22
Harrison,18,1242,442,800,357,587,73,199,4,6,3,4,0,0,5,4,436,788,6,12
Hartley,5,265,135,130,128,121,3,3,1,3,0,2,0,0,3,1,89,99,46,31
Hartley,6,404,259,145,200,138,48,2,2,4,3,0,0,0,6,1,172,105,87,40
Hartley,7,412,302,110,232,98,64,1,0,1,3,4,0,0,3,6,189,82,113,28
Hartley,8,414,301,113,240,107,55,2,0,2,5,1,0,0,1,1,191,81,110,32
Hartley,9,483,350,133,280,126,63,4,3,2,4,0,0,0,0,1,216,96,134,37
Hartley,10,496,345,151,292,147,45,1,1,2,6,1,0,0,1,0,240,116,105,35
Hartley,11,381,271,110,230,105,39,0,0,0,2,3,0,0,0,2,198,89,73,21
Hartley,12,356,196,160,180,155,16,2,0,0,0,1,0,0,0,2,164,141,32,19
Hartley,13,263,145,118,139,114,4,2,1,2,0,0,0,0,1,0,132,111,13,7
Hartley,14,205,103,102,98,99,4,0,0,1,0,0,0,0,1,2,89,90,14,12
Hartley,15,212,102,110,99,108,1,0,0,1,0,0,0,0,2,1,85,97,17,13
Hartley,16,190,90,100,87,98,1,0,1,1,0,0,0,0,1,1,80,96,10,4
Hartley,17,104,41,63,40,63,0,0,0,0,0,0,0,0,1,0,39,61,2,2
Hartley,18,121,46,75,44,74,1,0,1,0,0,0,0,1,0,0,39,71,7,4
Haskell,5,380,241,139,207,117,15,12,7,0,8,0,0,0,4,10,136,78,105,61
Haskell,6,396,243,153,209,136,20,9,3,1,6,2,0,0,5,5,151,102,92,51
Haskell,7,411,244,167,222,151,13,4,2,1,4,4,0,0,3,7,142,108,102,59
Haskell,8,358,223,135,194,131,15,3,3,1,5,0,0,0,6,0,152,101,71,34
Haskell,9,310,169,141,152,137,11,2,1,0,4,1,0,0,1,1,117,90,52,51
Haskell,10,287,162,125,143,113,14,8,4,2,1,1,0,0,0,1,115,90,47,35
Haskell,11,320,159,161,144,145,10,12,0,1,3,2,0,0,2,1,119,122,40,39
Haskell,12,416,204,212,196,196,7,10,1,0,0,2,0,0,0,4,150,173,54,39
Haskell,13,402,198,204,181,195,9,4,2,3,1,1,0,0,5,1,146,165,52,39
Haskell,14,378,199,179,191,171,5,2,1,3,0,1,0,0,2,2,160,149,39,30
Haskell,15,324,156,168,145,159,7,5,2,2,0,1,0,0,2,1,126,141,30,27
Haskell,16,223,103,120,99,111,2,6,1,0,0,0,0,0,1,3,90,101,13,19
Haskell,17,169,81,88,77,85,4,0,0,2,0,1,0,0,0,0,76,73,5,15
Haskell,18,179,64,115,61,109,2,2,0,3,0,0,0,0,1,1,61,106,3,9
Hays,5,27209,13334,13875,11654,12178,863,882,238,135,242,214,40,8,297,458,7990,8699,5344,5176
Hays,6,16428,8684,7744,7591,6889,606,431,97,103,180,152,18,16,192,153,4825,4230,3859,3514
Hays,7,15685,8117,7568,7254,6805,413,320,102,74,202,196,12,7,134,166,4440,4311,3677,3257
Hays,8,16259,8167,8092,7361,7286,381,339,90,91,189,192,14,4,132,180,4698,4624,3469,3468
Hays,9,13968,7127,6841,6376,6210,388,242,74,106,133,146,38,13,118,124,4159,3947,2968,2894
Hays,10,13371,6716,6655,6109,6073,271,241,121,80,120,162,8,6,87,93,4202,4040,2514,2615
Hays,11,11778,5826,5952,5336,5493,265,195,71,76,77,120,6,8,71,60,3791,3779,2035,2173
Hays,12,11915,5830,6085,5377,5596,240,232,73,75,68,95,7,5,65,82,4068,4348,1762,1737
Hays,13,10897,5121,5776,4704,5403,239,169,68,70,39,80,8,9,63,45,3915,4303,1206,1473
Hays,14,9275,4460,4815,4213,4517,125,116,37,45,40,88,6,5,39,44,3535,3695,925,1120
Hays,15,6782,3214,3568,3083,3363,49,82,36,41,16,54,1,1,29,27,2596,2832,618,736
Hays,16,3909,1772,2137,1689,2011,33,52,16,14,19,41,3,2,12,17,1461,1697,311,440
Hays,17,2421,1031,1390,973,1290,15,47,15,18,15,24,1,2,12,9,813,1082,218,308
Hays,18,2057,712,1345,681,1262,14,33,9,33,2,9,1,0,5,8,594,1068,118,277
Hemphill,5,170,82,88,73,78,2,1,4,5,0,1,0,0,3,3,42,50,40,38
Hemphill,6,175,87,88,78,84,2,1,5,0,1,2,0,0,1,1,40,52,47,36
Hemphill,7,222,118,104,111,94,1,2,0,5,3,3,0,0,3,0,76,65,42,39
Hemphill,8,248,119,129,111,125,0,0,3,2,4,2,0,0,1,0,73,74,46,55
Hemphill,9,279,133,146,126,139,1,0,2,4,3,1,0,1,1,1,93,90,40,56
Hemphill,10,231,124,107,120,103,1,2,0,0,1,0,0,0,2,2,74,75,50,32
Hemphill,11,199,102,97,99,92,0,2,0,0,1,2,0,0,2,1,72,73,30,24
Hemphill,12,245,125,120,119,113,0,1,2,0,2,4,0,0,2,2,82,96,43,24
Hemphill,13,204,104,100,102,97,0,0,1,0,1,0,0,2,0,1,92,84,12,16
Hemphill,14,181,90,91,90,90,0,0,0,0,0,1,0,0,0,0,79,83,11,8
Hemphill,15,154,73,81,73,80,0,0,0,1,0,0,0,0,0,0,62,77,11,4
Hemphill,16,99,44,55,43,54,0,0,0,0,0,1,0,0,1,0,41,52,3,3
Hemphill,17,64,21,43,20,42,0,0,0,0,0,0,0,0,1,1,19,42,2,1
Hemphill,18,84,37,47,36,44,0,0,0,1,0,1,0,0,1,1,35,44,2,3
Henderson,5,4471,2280,2191,1912,1936,247,165,34,27,11,13,2,0,74,50,1829,1750,451,441
Henderson,6,4653,2348,2305,2072,2081,195,155,23,18,17,14,5,8,36,29,1973,1932,375,373
Henderson,7,4470,2165,2305,1960,2058,136,161,19,25,17,19,1,3,32,39,1807,1998,358,307
Henderson,8,4395,2127,2268,1893,2020,153,164,13,23,15,32,6,2,47,27,1774,1881,353,387
Henderson,9,4223,2059,2164,1830,1928,149,153,20,25,27,27,0,2,33,29,1739,1896,320,268
Henderson,10,4894,2278,2616,2028,2396,181,144,17,19,19,18,0,4,33,35,1981,2300,297,316
Henderson,11,5100,2527,2573,2286,2314,152,183,36,23,15,24,3,1,35,28,2220,2288,307,285
Henderson,12,6086,2897,3189,2631,2877,185,210,27,35,15,20,2,4,37,43,2671,2939,226,250
Henderson,13,6180,2933,3247,2690,2973,168,179,36,23,12,31,1,3,26,38,2723,3082,210,165
Henderson,14,5535,2665,2870,2454,2656,104,134,42,23,6,26,0,2,59,29,2516,2753,149,117
Henderson,15,4812,2272,2540,2124,2384,71,111,19,13,15,11,3,1,40,20,2171,2446,101,94
Henderson,16,3609,1664,1945,1552,1837,62,81,20,4,13,3,2,0,15,20,1619,1888,45,57
Henderson,17,2229,1025,1204,971,1141,35,47,13,6,0,2,0,0,6,8,1003,1176,22,28
Henderson,18,1926,742,1184,703,1111,24,55,5,5,5,4,0,1,5,8,719,1154,23,30
Hidalgo,5,65806,32983,32823,32021,32032,311,212,210,194,284,259,16,11,141,115,1499,1260,31484,31563
Hidalgo,6,62235,31712,30523,30775,29652,401,258,168,202,224,288,10,11,134,112,1808,1525,29904,28998
Hidalgo,7,53756,27005,26751,26106,25942,330,207,184,151,278,332,13,15,94,104,1795,1499,25210,25252
Hidalgo,8,54685,26749,27936,25856,27077,315,213,168,164,284,366,30,14,96,102,1741,1539,25008,26397
Hidalgo,9,54354,26313,28041,25420,27204,265,176,142,166,374,380,12,10,100,105,1660,1462,24653,26579
Hidalgo,10,51260,24379,26881,23432,26013,275,151,133,145,442,457,10,16,87,99,1909,1627,22470,25254
Hidalgo,11,43261,20425,22836,19711,22139,226,120,101,123,275,355,8,7,104,92,1755,1625,18670,21211
Hidalgo,12,38303,18101,20202,17425,19618,185,127,97,83,298,305,10,9,86,60,1893,1777,16208,18425
Hidalgo,13,33379,15291,18088,14711,17524,146,95,99,87,267,298,2,7,66,77,2007,2119,13284,15969
Hidalgo,14,29155,13214,15941,12811,15581,99,66,63,62,160,175,1,8,80,49,2329,2487,10885,13454
Hidalgo,15,24294,10996,13298,10732,13031,63,66,63,54,100,101,1,6,37,40,2597,2742,8399,10556
Hidalgo,16,17598,7794,9804,7663,9625,30,33,18,42,59,79,1,1,23,24,2349,2525,5445,7279
Hidalgo,17,12671,5434,7237,5322,7097,17,23,35,41,33,49,0,1,27,26,1826,1901,3608,5336
Hidalgo,18,11952,4819,7133,4716,7030,21,20,39,33,22,45,1,2,20,3,1896,1910,2923,5223
Hill,5,1958,1049,909,910,788,100,87,6,10,10,7,1,0,22,17,725,638,324,271
Hill,6,1999,1015,984,885,860,99,75,5,6,4,20,3,1,19,22,727,712,288,272
Hill,7,2091,988,1103,882,984,76,72,10,14,4,13,0,2,16,18,722,839,266,264
Hill,8,2074,1052,1022,954,919,54,73,15,6,12,8,2,4,15,12,754,791,298,231
Hill,9,1832,919,913,837,802,56,76,10,13,6,8,2,2,8,12,710,710,209,203
Hill,10,2089,1035,1054,947,959,59,65,13,7,5,9,0,0,11,14,800,842,235,212
Hill,11,2207,1086,1121,976,1010,75,83,12,12,3,7,6,1,14,8,879,934,207,187
Hill,12,2537,1228,1309,1143,1176,56,97,12,12,4,7,0,2,13,15,1025,1151,203,158
Hill,13,2499,1222,1277,1138,1175,54,64,13,12,4,11,2,0,11,15,1062,1170,160,107
Hill,14,2263,1127,1136,1038,1056,73,63,7,1,3,8,0,1,6,7,1012,1050,115,86
Hill,15,1966,972,994,913,933,37,42,16,7,1,2,1,3,4,7,900,932,72,62
Hill,16,1436,693,743,655,687,25,36,6,8,2,6,1,1,4,5,653,702,40,41
Hill,17,918,446,472,417,440,12,21,4,3,2,0,2,0,9,8,429,449,17,23
Hill,18,884,326,558,309,523,11,26,2,0,0,0,1,0,3,9,297,533,29,25
Hockley,5,1619,870,749,771,677,58,42,7,12,6,3,4,1,24,14,409,323,461,426
Hockley,6,1625,857,768,789,706,27,39,25,8,6,5,0,0,10,10,377,352,480,416
Hockley,7,1499,764,735,705,705,26,17,17,8,5,2,4,0,7,3,338,326,426,409
Hockley,8,1501,772,729,721,692,30,18,9,11,2,2,0,1,10,5,330,340,442,389
Hockley,9,1193,595,598,549,565,21,14,7,8,15,6,1,0,2,5,299,298,296,300
Hockley,10,1208,555,653,516,619,16,22,14,5,8,1,0,0,1,6,292,360,263,293
Hockley,11,1278,621,657,583,619,23,22,6,6,3,3,0,0,6,7,350,366,271,291
Hockley,12,1419,684,735,643,680,23,27,11,19,2,1,0,0,5,8,413,455,271,280
Hockley,13,1319,663,656,623,615,28,29,7,6,2,2,0,1,3,3,429,435,234,221
Hockley,14,1076,535,541,505,512,19,23,5,5,2,1,0,0,4,0,389,378,146,163
Hockley,15,827,370,457,352,438,6,8,4,5,0,1,1,0,7,5,264,314,106,143
Hockley,16,618,272,346,257,334,9,3,4,4,1,0,0,1,1,4,218,266,54,80
Hockley,17,483,208,275,191,260,10,12,1,1,1,2,0,0,5,0,159,219,49,56
Hockley,18,382,166,216,157,200,3,9,4,5,0,0,0,0,2,2,135,174,31,42
Hood,5,2760,1415,1345,1332,1286,17,17,18,14,9,6,1,1,38,21,1164,1100,251,245
Hood,6,3173,1567,1606,1477,1528,27,20,28,14,12,19,2,2,21,23,1261,1337,306,269
Hood,7,3196,1588,1608,1506,1523,30,25,20,20,16,13,1,0,15,27,1267,1382,321,226
Hood,8,3338,1656,1682,1564,1581,26,20,19,17,17,42,2,4,28,18,1358,1414,298,268
Hood,9,2921,1432,1489,1357,1420,28,19,20,11,11,27,1,0,15,12,1209,1289,223,200
Hood,10,3270,1569,1701,1507,1627,18,15,17,14,17,26,1,1,9,18,1407,1481,162,220
Hood,11,3697,1784,1913,1720,1839,19,18,16,21,13,16,0,1,16,18,1555,1689,229,224
Hood,12,4415,2133,2282,2037,2189,24,12,31,29,16,23,1,3,24,26,1937,2123,196,159
Hood,13,4731,2251,2480,2173,2408,18,11,21,19,13,19,2,2,24,21,2088,2324,163,156
Hood,14,4564,2129,2435,2071,2345,17,17,10,23,8,23,3,8,20,19,2040,2337,89,98
Hood,15,3983,1907,2076,1869,2035,10,3,11,13,1,12,0,0,16,13,1847,2010,60,66
Hood,16,2822,1377,1445,1344,1422,7,3,15,8,4,6,0,1,7,5,1338,1418,39,27
Hood,17,1823,863,960,847,943,1,0,6,3,3,3,0,1,6,10,840,948,23,12
Hood,18,1644,631,1013,619,991,2,2,3,7,2,3,2,4,3,6,608,993,23,20
Hopkins,5,2155,1104,1051,961,915,88,90,18,10,6,9,1,1,30,26,828,771,276,280
Hopkins,6,2248,1121,1127,966,987,112,101,19,13,6,4,2,2,16,20,864,891,257,236
Hopkins,7,2243,1120,1123,999,1010,81,68,7,16,12,14,1,1,20,14,857,914,263,209
Hopkins,8,2070,1027,1043,939,928,61,82,11,11,9,6,1,1,6,15,802,878,225,165
Hopkins,9,2043,988,1055,881,946,64,73,7,12,17,5,1,3,18,16,794,841,194,214
Hopkins,10,2272,1105,1167,993,1023,82,97,10,19,7,13,2,3,11,12,933,1008,172,159
Hopkins,11,2270,1100,1170,981,1053,76,80,16,10,9,11,4,1,14,15,943,1019,157,151
Hopkins,12,2516,1262,1254,1152,1116,76,106,13,9,9,10,0,1,12,12,1055,1146,207,108
Hopkins,13,2331,1144,1187,1009,1087,108,80,10,8,7,5,2,0,8,7,1035,1114,109,73
Hopkins,14,2108,985,1123,882,1004,83,89,6,12,5,6,1,0,8,12,923,1069,62,54
Hopkins,15,1714,797,917,741,824,40,70,6,6,2,8,1,0,7,9,767,895,30,22
Hopkins,16,1269,597,672,546,618,37,47,7,2,4,2,0,1,3,2,572,646,25,26
Hopkins,17,846,365,481,351,441,8,30,4,3,0,1,0,0,2,6,355,474,10,7
Hopkins,18,767,283,484,261,449,16,24,1,4,1,1,0,0,4,6,267,475,16,9
Houston,5,1100,621,479,419,335,185,120,4,6,5,6,0,0,8,12,520,398,101,81
Houston,6,1391,767,624,503,392,243,188,6,1,9,35,0,0,6,8,630,542,137,82
Houston,7,1308,797,511,502,349,277,144,6,1,6,13,0,0,6,4,631,455,166,56
Houston,8,1504,918,586,619,407,279,163,6,7,4,4,0,0,10,5,746,532,172,54
Houston,9,1445,885,560,565,385,307,154,2,6,5,7,0,0,6,8,724,495,161,65
Houston,10,1507,940,567,582,404,336,149,9,3,6,6,0,0,7,5,820,519,120,48
Houston,11,1560,900,660,609,461,280,183,5,9,1,1,1,0,4,6,784,616,116,44
Houston,12,1588,835,753,602,578,216,168,9,3,2,3,0,0,6,1,764,707,71,46
Houston,13,1596,766,830,592,625,166,191,2,4,2,4,0,0,4,6,714,797,52,33
Houston,14,1470,701,769,574,605,109,154,7,3,5,3,0,0,6,4,662,751,39,18
Houston,15,1297,633,664,521,554,102,103,5,0,1,4,0,0,4,3,606,656,27,8
Houston,16,949,459,490,381,407,69,78,3,2,4,2,0,0,2,1,448,478,11,12
Houston,17,732,328,404,274,336,46,62,5,3,0,1,0,0,3,2,322,396,6,8
Houston,18,645,256,389,210,312,38,68,1,4,1,1,0,0,6,4,249,383,7,6
Howard,5,2391,1495,896,1240,790,172,56,20,20,25,8,3,0,35,22,758,430,737,466
Howard,6,2892,1712,1180,1465,1076,167,59,30,11,29,9,0,2,21,23,866,618,846,562
Howard,7,2879,1760,1119,1527,1001,177,58,20,29,18,13,0,1,18,17,909,612,851,507
Howard,8,2315,1280,1035,1137,930,93,60,21,18,14,16,2,0,13,11,682,578,598,457
Howard,9,2316,1430,886,1205,811,145,37,30,11,29,14,2,0,19,13,780,507,650,379
Howard,10,2641,1723,918,1407,858,223,30,33,4,39,12,0,2,21,12,944,534,779,384
Howard,11,2733,1853,880,1469,803,272,43,52,15,35,6,4,1,21,12,1047,513,806,367
Howard,12,2306,1316,990,1159,923,113,32,27,27,8,4,2,1,7,3,876,697,440,293
Howard,13,1926,983,943,893,870,44,37,20,13,10,10,2,1,14,12,703,679,280,264
Howard,14,1567,801,766,747,710,23,35,17,6,5,9,1,0,8,6,568,545,233,221
Howard,15,1036,495,541,446,502,28,18,9,11,1,4,0,0,11,6,361,396,134,145
Howard,16,807,353,454,327,437,13,9,6,3,3,2,0,0,4,3,273,345,80,109
Howard,17,633,290,343,274,326,8,4,5,4,2,6,0,0,1,3,226,275,64,68
Howard,18,634,263,371,247,357,8,5,5,5,2,4,0,0,1,0,221,292,42,79
Hudspeth,5,353,199,154,188,135,5,4,1,9,0,3,1,2,4,1,23,25,176,129
Hudspeth,6,490,275,215,239,202,17,5,8,2,6,1,0,1,5,4,61,37,214,178
Hudspeth,7,469,248,221,214,201,15,5,2,7,6,4,2,1,9,3,51,38,197,183
Hudspeth,8,377,226,151,202,137,13,5,3,4,3,3,1,0,4,2,39,32,187,119
Hudspeth,9,339,207,132,174,122,25,2,3,5,1,2,0,0,4,1,45,23,162,109
Hudspeth,10,236,125,111,110,102,10,5,2,0,2,1,0,0,1,3,30,20,95,91
Hudspeth,11,201,97,104,85,99,2,0,6,3,1,2,0,0,3,0,31,25,66,79
Hudspeth,12,244,122,122,114,110,4,8,2,2,1,1,1,0,0,1,26,39,96,83
Hudspeth,13,230,104,126,100,118,1,1,0,4,1,2,0,0,2,1,39,42,65,84
Hudspeth,14,219,103,116,95,109,2,3,3,0,1,1,0,0,2,3,45,30,58,86
Hudspeth,15,200,116,84,108,79,2,0,3,3,0,2,0,0,3,0,39,21,77,63
Hudspeth,16,141,78,63,75,61,1,1,0,0,2,1,0,0,0,0,34,20,44,43
Hudspeth,17,70,39,31,36,29,2,0,1,1,0,1,0,0,0,0,8,8,31,23
Hudspeth,18,92,45,47,45,47,0,0,0,0,0,0,0,0,0,0,9,12,36,35
Hunt,5,6581,3354,3227,2624,2552,380,373,49,45,191,146,11,8,99,103,2593,2535,761,692
Hunt,6,6365,3205,3160,2618,2587,353,360,46,42,112,76,10,6,66,89,2584,2593,621,567
Hunt,7,5811,2812,2999,2449,2536,254,280,23,72,40,51,4,6,42,54,2199,2498,613,501
Hunt,8,5858,2902,2956,2533,2555,236,263,39,32,46,55,8,6,40,45,2337,2404,565,552
Hunt,9,5389,2636,2753,2341,2383,176,237,38,38,49,45,4,13,28,37,2134,2276,502,477
Hunt,10,6076,2985,3091,2662,2712,202,239,35,34,34,58,6,10,46,38,2490,2662,495,429
Hunt,11,6350,3134,3216,2811,2844,209,238,45,49,26,40,7,2,36,43,2678,2816,456,400
Hunt,12,6678,3296,3382,2955,3004,214,246,46,44,46,39,6,4,29,45,2928,3072,368,310
Hunt,13,6100,3011,3089,2754,2750,194,253,20,28,18,22,1,1,24,35,2754,2881,257,208
Hunt,14,4901,2317,2584,2090,2353,139,158,31,20,19,19,3,5,35,29,2161,2445,156,139
Hunt,15,4007,1902,2105,1762,1920,97,116,16,28,10,22,1,2,16,17,1820,2015,82,90
Hunt,16,2863,1302,1561,1197,1414,62,85,12,19,6,27,0,1,25,15,1259,1501,43,60
Hunt,17,1894,816,1078,749,995,35,58,14,7,3,6,1,0,14,12,785,1049,31,29
Hunt,18,1641,621,1020,579,934,27,70,2,7,3,2,0,0,10,7,600,981,21,39
Hutchinson,5,1203,608,595,545,541,34,17,11,15,2,9,1,0,15,13,416,386,192,209
Hutchinson,6,1340,712,628,638,570,26,22,17,12,5,8,2,0,24,16,509,453,203,175
Hutchinson,7,1286,656,630,597,581,16,15,20,20,10,6,2,1,11,7,474,479,182,151
Hutchinson,8,1347,690,657,634,617,26,16,15,12,2,4,2,0,11,8,483,479,207,178
Hutchinson,9,1321,663,658,609,604,23,20,13,17,6,3,0,0,12,14,476,493,187,165
Hutchinson,10,1246,626,620,578,574,16,16,12,16,3,6,0,0,17,8,472,481,154,139
Hutchinson,11,1104,572,532,528,487,16,15,13,14,5,4,0,1,10,11,445,442,127,90
Hutchinson,12,1418,720,698,670,646,15,19,21,18,6,5,1,0,7,10,597,603,123,95
Hutchinson,13,1405,721,684,671,635,23,23,14,14,4,7,0,1,9,4,631,609,90,75
Hutchinson,14,1167,578,589,552,549,15,16,7,13,1,1,0,0,3,10,519,530,59,59
Hutchinson,15,854,421,433,401,408,12,9,5,8,2,3,0,1,1,4,380,390,41,43
Hutchinson,16,593,291,302,265,282,9,6,6,6,3,2,0,0,8,6,260,280,31,22
Hutchinson,17,430,178,252,162,236,0,2,7,6,0,3,1,0,8,5,172,231,6,21
Hutchinson,18,470,196,274,184,254,2,6,8,9,0,0,0,0,2,5,186,263,10,11
Irion,5,74,40,34,36,33,2,0,1,1,1,0,0,0,0,0,33,25,7,9
Irion,6,92,55,37,53,34,2,0,0,0,0,0,0,0,0,3,36,33,19,4
Irion,7,95,50,45,49,41,0,2,0,2,0,0,0,0,1,0,32,35,18,10
Irion,8,66,37,29,35,28,0,0,0,0,0,0,0,0,2,1,20,26,17,3
Irion,9,81,46,35,45,33,0,0,0,1,0,0,0,0,1,1,33,22,13,13
Irion,10,95,47,48,47,45,0,2,0,0,0,0,0,0,0,1,34,39,13,9
Irion,11,85,47,38,45,37,0,0,2,1,0,0,0,0,0,0,34,23,13,15
Irion,12,124,68,56,63,54,1,1,0,0,1,1,0,0,3,0,54,48,14,8
Irion,13,116,45,71,41,69,0,1,3,0,0,0,0,0,1,1,35,49,10,22
Irion,14,95,50,45,50,45,0,0,0,0,0,0,0,0,0,0,40,40,10,5
Irion,15,86,42,44,40,42,0,0,1,0,0,0,0,0,1,2,31,34,11,10
Irion,16,75,37,38,35,37,1,1,1,0,0,0,0,0,0,0,36,33,1,5
Irion,17,25,12,13,12,13,0,0,0,0,0,0,0,0,0,0,6,6,6,7
Irion,18,41,17,24,15,24,0,0,0,0,0,0,0,0,2,0,13,22,4,2
Jack,5,602,403,199,337,185,53,0,4,6,4,1,0,2,5,5,302,150,101,49
Jack,6,656,450,206,384,200,57,2,2,2,1,1,2,1,4,0,334,167,116,39
Jack,7,592,375,217,325,204,39,2,6,3,3,3,1,1,1,4,303,185,72,32
Jack,8,542,338,204,300,195,34,4,0,1,1,2,0,0,3,2,269,171,69,33
Jack,9,513,272,241,236,233,28,1,2,3,4,3,0,0,2,1,218,189,54,52
Jack,10,557,327,230,289,221,26,0,8,3,2,2,0,0,2,4,276,190,51,40
Jack,11,606,360,246,326,239,26,2,1,2,4,2,0,0,3,1,315,211,45,35
Jack,12,600,328,272,308,267,13,0,4,3,0,1,0,0,3,1,291,250,37,22
Jack,13,498,262,236,250,227,4,5,7,1,0,1,0,0,1,2,238,226,24,10
Jack,14,468,236,232,227,221,2,5,2,4,0,2,0,0,5,0,224,228,12,4
Jack,15,398,188,210,183,205,3,2,2,1,0,0,0,0,0,2,185,205,3,5
Jack,16,284,138,146,136,143,0,1,1,2,0,0,0,0,1,0,128,137,10,9
Jack,17,204,89,115,87,114,0,0,2,0,0,0,0,0,0,1,85,109,4,6
Jack,18,141,59,82,59,78,0,2,0,0,0,0,0,0,0,2,57,78,2,4
Jackson,5,803,408,395,354,341,38,35,5,6,3,6,0,0,8,7,241,217,167,178
Jackson,6,912,450,462,383,412,36,30,9,5,8,12,0,0,14,3,279,295,171,167
Jackson,7,933,520,413,486,362,18,22,0,7,11,11,0,1,5,10,269,245,251,168
Jackson,8,986,489,497,451,453,18,25,4,4,7,9,1,0,8,6,280,319,209,178
Jackson,9,772,381,391,347,355,26,26,2,2,4,6,0,0,2,2,242,263,139,128
Jackson,10,824,426,398,396,372,20,17,3,3,2,2,0,0,5,4,283,274,143,124
Jackson,11,849,421,428,376,377,28,39,8,2,3,5,2,0,4,5,288,301,133,127
Jackson,12,948,490,458,447,419,28,27,1,7,6,3,0,0,8,2,357,356,133,102
Jackson,13,997,482,515,433,474,38,29,5,4,3,2,0,0,3,6,351,424,131,91
Jackson,14,823,434,389,388,345,29,39,4,2,5,0,0,1,8,2,353,321,81,68
Jackson,15,597,284,313,260,294,16,15,2,1,0,1,0,0,6,2,239,264,45,49
Jackson,16,505,227,278,214,254,8,13,3,4,0,2,0,0,2,5,192,240,35,38
Jackson,17,360,148,212,138,197,6,8,0,2,3,0,0,0,1,5,129,185,19,27
Jackson,18,372,132,240,126,220,2,17,0,1,2,2,0,0,2,0,116,216,16,24
Jasper,5,1935,1004,931,756,704,208,182,12,17,6,12,0,1,22,15,885,841,119,90
Jasper,6,2143,1112,1031,879,822,213,184,5,10,5,3,0,2,10,10,1000,954,112,77
Jasper,7,1962,953,1009,792,832,141,155,8,8,4,4,1,1,7,9,845,940,108,69
Jasper,8,2093,1082,1011,910,825,155,163,8,4,2,11,0,0,7,8,966,940,116,71
Jasper,9,1855,919,936,750,746,146,150,4,11,12,19,0,2,7,8,828,869,91,67
Jasper,10,2103,1011,1092,839,910,144,159,9,8,10,9,1,0,8,6,942,1038,69,54
Jasper,11,2254,1119,1135,907,921,186,189,11,9,4,7,1,1,10,8,1054,1099,65,36
Jasper,12,2586,1274,1312,1043,1052,206,236,10,7,5,7,1,0,9,10,1204,1273,70,39
Jasper,13,2492,1196,1296,996,1046,171,233,9,8,10,3,0,0,10,6,1151,1258,45,38
Jasper,14,2235,1053,1182,891,1009,144,148,9,4,2,8,0,3,7,10,1031,1151,22,31
Jasper,15,1834,859,975,753,833,90,119,10,7,1,4,0,2,5,10,851,953,8,22
Jasper,16,1392,652,740,573,630,72,97,2,6,1,1,1,0,3,6,640,735,12,5
Jasper,17,846,380,466,346,401,28,61,3,1,2,0,0,0,1,3,369,462,11,4
Jasper,18,714,284,430,260,375,23,43,1,2,0,1,0,0,0,9,275,416,9,14
Jeff,5,78,41,37,39,34,1,2,1,0,0,0,0,0,0,1,15,21,26,16
Jeff,6,101,57,44,48,39,2,1,3,0,0,0,0,0,4,4,30,22,27,22
Jeff,7,112,55,57,53,55,0,1,0,0,0,0,0,0,2,1,18,36,37,21
Jeff,8,92,48,44,46,43,0,0,0,0,2,1,0,0,0,0,26,20,22,24
Jeff,9,111,53,58,52,54,1,1,0,2,0,0,0,0,0,1,26,35,27,23
Jeff,10,156,69,87,65,68,1,1,2,0,0,16,0,0,1,2,33,61,36,26
Jeff,11,136,68,68,65,63,1,0,1,1,0,4,0,0,1,0,42,39,26,29
Jeff,12,210,105,105,100,99,2,0,1,1,0,0,0,0,2,5,69,69,36,36
Jeff,13,265,136,129,131,123,0,0,1,4,0,1,0,0,4,1,104,101,32,28
Jeff,14,260,130,130,126,125,0,0,2,2,0,0,0,0,2,3,108,109,22,21
Jeff,15,222,127,95,122,91,1,3,2,0,1,1,0,0,1,0,99,78,28,17
Jeff,16,148,83,65,75,63,3,0,1,0,1,1,0,0,3,1,61,51,22,14
Jeff,17,69,41,28,40,28,0,0,0,0,0,0,0,0,1,0,28,16,13,12
Jeff,18,86,28,58,28,56,0,1,0,1,0,0,0,0,0,0,23,42,5,16
Jefferson,5,17149,9041,8108,4994,4300,3311,3172,130,122,411,344,8,7,187,163,6591,6179,2450,1929
Jefferson,6,19079,10408,8671,5987,4767,3664,3258,144,80,449,411,6,6,158,149,7798,6800,2610,1871
Jefferson,7,17947,9919,8028,6033,4540,3298,2870,136,76,339,421,13,12,100,109,7233,6294,2686,1734
Jefferson,8,17332,9457,7875,5770,4479,3143,2763,99,72,336,463,13,10,96,88,6912,6225,2545,1650
Jefferson,9,15096,8106,6990,5033,4025,2446,2450,106,80,391,349,11,4,119,82,5846,5413,2260,1577
Jefferson,10,15078,7976,7102,4863,4077,2510,2440,87,71,419,422,5,8,92,84,6135,5710,1841,1392
Jefferson,11,15036,7738,7298,4699,4148,2547,2713,101,60,320,309,9,4,62,64,6292,6248,1446,1050
Jefferson,12,16718,8455,8263,5259,4878,2662,2984,72,53,386,273,13,7,63,68,7207,7373,1248,890
Jefferson,13,15373,7429,7944,4755,4761,2282,2827,55,47,265,246,8,2,64,61,6483,7204,946,740
Jefferson,14,12018,5785,6233,3718,3819,1807,2158,37,37,176,170,3,1,44,48,5217,5683,568,550
Jefferson,15,8972,4156,4816,2775,3067,1215,1578,30,22,105,118,4,2,27,29,3781,4465,375,351
Jefferson,16,6244,2636,3608,1811,2411,699,1091,17,19,79,68,3,0,27,19,2418,3353,218,255
Jefferson,17,4546,1846,2700,1289,1884,473,730,15,10,52,58,0,0,17,18,1701,2530,145,170
Jefferson,18,4997,1802,3195,1354,2371,394,760,15,10,33,40,0,0,6,14,1652,2986,150,209
Jim,5,291,142,149,136,143,4,2,2,2,0,0,0,2,0,0,12,6,130,143
Jim,6,280,154,126,143,122,1,0,5,1,1,0,0,0,4,3,13,9,141,117
Jim,7,324,177,147,170,145,3,1,0,0,1,1,0,0,3,0,8,7,169,140
Jim,8,292,157,135,155,133,0,0,0,0,1,1,0,0,1,1,9,7,148,128
Jim,9,316,165,151,161,147,3,2,1,0,0,2,0,0,0,0,11,15,154,136
Jim,10,237,117,120,114,116,1,0,0,1,1,3,0,0,1,0,12,10,105,110
Jim,11,286,150,136,146,135,2,1,0,0,2,0,0,0,0,0,11,11,139,125
Jim,12,291,144,147,143,142,1,0,0,0,0,0,0,0,0,5,9,11,135,136
Jim,13,245,124,121,120,119,1,0,0,0,2,1,0,0,1,1,14,12,110,109
Jim,14,270,114,156,112,154,0,0,2,1,0,1,0,0,0,0,11,13,103,143
Jim,15,251,126,125,123,121,1,2,2,0,0,1,0,0,0,1,12,11,114,114
Jim,16,184,80,104,79,103,0,1,0,0,1,0,0,0,0,0,11,12,69,92
Jim,17,129,53,76,53,74,0,1,0,0,0,0,0,0,0,1,5,6,48,70
Jim,18,69,29,40,28,39,0,0,0,1,0,0,0,0,1,0,5,8,24,32
Jim,5,2578,1336,1242,1286,1205,11,12,21,9,7,7,0,1,11,8,184,186,1152,1056
Jim,6,2710,1361,1349,1287,1308,41,5,19,18,6,4,1,2,7,12,224,203,1137,1146
Jim,7,2595,1299,1296,1221,1220,44,5,19,8,4,51,1,1,10,11,219,251,1080,1045
Jim,8,2670,1372,1298,1342,1259,10,10,6,14,5,12,2,0,7,3,267,263,1105,1035
Jim,9,2261,1111,1150,1086,1120,7,8,13,7,3,7,0,0,2,8,198,204,913,946
Jim,10,2304,1115,1189,1068,1157,15,8,15,7,6,11,1,1,10,5,218,224,897,965
Jim,11,2259,1052,1207,1010,1182,16,4,18,14,3,2,2,0,3,5,219,268,833,939
Jim,12,2403,1160,1243,1119,1209,6,6,19,13,3,8,3,0,10,7,318,297,842,946
Jim,13,2214,1053,1161,1014,1116,13,11,15,10,5,10,2,0,4,14,297,331,756,830
Jim,14,1991,997,994,961,972,12,4,10,9,9,2,0,1,5,6,306,276,691,718
Jim,15,1645,782,863,754,842,3,2,15,8,4,5,0,2,6,4,204,183,578,680
Jim,16,1074,477,597,468,587,3,2,1,4,0,1,0,0,5,3,140,138,337,459
Jim,17,841,362,479,357,461,2,1,2,6,0,2,0,0,1,9,98,141,264,338
Jim,18,735,255,480,238,466,5,5,7,5,2,0,0,2,3,2,97,147,158,333
Johnson,5,10339,5327,5012,4776,4525,283,203,46,73,49,42,29,37,144,132,3739,3477,1588,1535
Johnson,6,11144,5673,5471,5093,4978,306,207,67,69,60,89,53,34,94,94,4133,4165,1540,1306
Johnson,7,11272,5650,5622,5111,5153,290,224,50,51,73,82,31,32,95,80,4104,4310,1546,1312
Johnson,8,11519,5834,5685,5254,5206,324,229,70,59,59,77,34,27,93,87,4368,4400,1466,1285
Johnson,9,10487,5217,5270,4768,4842,255,204,51,58,52,62,33,29,58,75,3932,4097,1285,1173
Johnson,10,11222,5615,5607,5162,5216,271,189,69,60,37,62,24,18,52,62,4406,4509,1209,1098
Johnson,11,10979,5581,5398,5197,5054,211,182,61,53,53,57,14,12,45,40,4530,4475,1051,923
Johnson,12,11321,5676,5645,5314,5341,178,153,61,38,30,45,9,6,84,62,4841,4951,835,694
Johnson,13,9954,4862,5092,4611,4765,148,160,30,49,27,56,7,8,39,54,4282,4613,580,479
Johnson,14,8040,3746,4294,3531,4060,106,132,34,32,28,28,4,4,43,38,3390,3883,356,411
Johnson,15,6677,3056,3621,2887,3485,77,72,23,21,28,18,2,3,39,22,2773,3299,283,322
Johnson,16,4392,2010,2382,1927,2292,34,46,19,11,12,15,3,2,15,16,1838,2219,172,163
Johnson,17,2876,1263,1613,1213,1554,15,24,12,8,7,15,1,0,15,12,1190,1510,73,103
Johnson,18,2146,809,1337,780,1274,11,36,10,6,2,12,1,1,5,8,745,1269,64,68
Jones,5,1539,1165,374,746,345,358,18,23,4,19,3,0,0,19,4,710,259,455,115
Jones,6,1727,1342,385,908,353,369,17,28,9,13,3,0,0,24,3,817,272,525,113
Jones,7,1664,1247,417,848,387,361,13,12,9,11,2,0,0,15,6,794,306,453,111
Jones,8,1551,1160,391,802,359,317,18,13,6,9,3,0,0,19,5,757,286,403,105
Jones,9,1412,1032,380,735,349,254,21,13,4,11,3,0,0,19,3,701,279,331,101
Jones,10,1447,989,458,738,428,226,13,6,11,14,4,1,0,4,2,715,350,274,108
Jones,11,1238,798,440,627,414,151,13,6,3,9,5,0,0,5,5,615,364,183,76
Jones,12,1252,697,555,606,510,74,25,13,13,1,5,0,0,3,2,555,445,142,110
Jones,13,1120,583,537,511,490,60,23,7,12,2,2,0,0,3,10,484,463,99,74
Jones,14,932,481,451,435,423,30,14,11,6,0,3,0,0,5,5,408,391,73,60
Jones,15,812,397,415,377,403,16,8,1,1,1,1,0,0,2,2,339,352,58,63
Jones,16,559,259,300,248,284,6,11,3,2,1,0,0,0,1,3,221,267,38,33
Jones,17,411,181,230,170,219,7,7,3,1,0,1,0,0,1,2,163,199,18,31
Jones,18,393,169,224,159,214,7,7,2,2,0,0,0,0,1,1,151,202,18,22
Karnes,5,1243,849,394,637,375,203,4,4,4,2,5,0,0,3,6,384,121,465,273
Karnes,6,1482,1064,418,777,399,273,9,3,4,6,3,0,0,5,3,499,134,565,284
Karnes,7,1353,945,408,687,382,238,6,8,4,5,5,1,1,6,10,427,138,518,270
Karnes,8,1197,803,394,621,365,162,12,15,8,3,3,0,0,2,6,349,149,454,245
Karnes,9,1004,647,357,518,339,112,4,12,8,4,2,0,1,1,3,292,134,355,223
Karnes,10,897,575,322,467,305,93,8,13,7,0,2,0,0,2,0,297,133,278,189
Karnes,11,796,429,367,374,353,46,5,7,1,0,6,0,0,2,2,230,183,199,184
Karnes,12,879,503,376,456,352,34,11,4,6,4,1,0,0,5,6,289,180,214,196
Karnes,13,860,441,419,413,397,16,16,4,4,3,1,0,0,5,1,263,235,178,184
Karnes,14,653,312,341,297,325,10,6,2,3,2,5,0,0,1,2,200,191,112,150
Karnes,15,523,242,281,231,276,9,4,0,1,1,0,0,0,1,0,162,161,80,120
Karnes,16,379,183,196,178,193,5,2,0,1,0,0,0,0,0,0,121,121,62,75
Karnes,17,335,124,211,123,206,1,3,0,1,0,0,0,0,0,1,75,132,49,79
Karnes,18,319,122,197,119,195,3,1,0,1,0,0,0,0,0,0,91,139,31,58
Kaufman,5,7145,3621,3524,2930,2847,533,510,39,31,24,35,3,4,92,97,2568,2538,1053,986
Kaufman,6,8274,3936,4338,3297,3559,478,573,47,46,40,76,3,0,71,84,2879,3174,1057,1164
Kaufman,7,9283,4512,4771,3732,3900,580,653,43,40,77,97,11,5,69,76,3340,3590,1172,1181
Kaufman,8,9419,4634,4785,3844,3860,560,691,41,73,92,91,8,6,89,64,3434,3668,1200,1117
Kaufman,9,8644,4286,4358,3578,3552,541,621,38,49,61,86,4,5,64,45,3220,3348,1066,1010
Kaufman,10,8597,4218,4379,3488,3595,561,628,51,42,72,72,1,2,45,40,3362,3521,856,858
Kaufman,11,7950,3877,4073,3245,3366,514,581,39,32,35,53,5,2,39,39,3199,3447,678,626
Kaufman,12,7898,3954,3944,3430,3334,398,488,54,30,39,52,1,3,32,37,3394,3508,560,436
Kaufman,13,7065,3445,3620,2980,3098,368,407,30,46,28,34,4,1,35,34,3089,3319,356,301
Kaufman,14,5444,2595,2849,2239,2501,276,258,31,20,29,33,1,3,19,34,2372,2619,223,230
Kaufman,15,4046,1862,2184,1647,1835,168,265,17,19,11,30,0,0,19,35,1719,2029,143,155
Kaufman,16,2761,1277,1484,1143,1308,98,139,13,12,12,8,0,1,11,16,1213,1414,64,70
Kaufman,17,1642,714,928,635,825,49,81,12,6,6,7,0,0,12,9,677,888,37,40
Kaufman,18,1467,484,983,446,897,30,73,6,1,1,9,0,2,1,1,457,941,27,42
Kendall,5,2416,1270,1146,1174,1079,25,13,20,10,12,20,2,0,37,24,845,801,425,345
Kendall,6,2082,1048,1034,981,961,15,14,13,8,19,16,2,2,18,33,732,678,316,356
Kendall,7,2409,1199,1210,1120,1122,22,18,14,8,17,25,1,3,25,34,759,792,440,418
Kendall,8,2757,1322,1435,1237,1352,34,22,10,11,30,32,0,1,11,17,864,971,458,464
Kendall,9,2959,1473,1486,1380,1395,32,23,9,5,25,40,2,3,25,20,1042,1049,431,437
Kendall,10,3059,1519,1540,1453,1460,21,18,12,10,17,31,1,2,15,19,1132,1172,387,368
Kendall,11,3067,1487,1580,1410,1495,34,17,10,5,11,43,2,0,20,20,1181,1252,306,328
Kendall,12,3332,1591,1741,1522,1660,25,18,10,11,12,33,2,1,20,18,1310,1472,281,269
Kendall,13,3179,1531,1648,1464,1591,18,15,14,9,10,12,3,1,22,20,1310,1429,221,219
Kendall,14,2753,1333,1420,1283,1383,19,10,11,9,5,8,2,1,13,9,1171,1259,162,161
Kendall,15,2299,1113,1186,1079,1152,7,4,7,7,6,12,0,0,14,11,1028,1064,85,122
Kendall,16,1585,727,858,703,839,7,4,2,6,5,4,1,0,9,5,646,781,81,77
Kendall,17,979,450,529,435,509,2,2,5,9,4,7,0,1,4,1,404,484,46,45
Kendall,18,1050,353,697,345,683,5,3,2,0,0,3,0,0,1,8,329,635,24,62
Kenedy,5,24,12,12,10,10,1,0,1,2,0,0,0,0,0,0,3,2,9,10
Kenedy,6,18,5,13,4,12,1,1,0,0,0,0,0,0,0,0,2,6,3,7
Kenedy,7,33,17,16,14,14,3,0,0,0,0,0,0,0,0,2,5,4,12,12
Kenedy,8,28,12,16,12,16,0,0,0,0,0,0,0,0,0,0,5,3,7,13
Kenedy,9,17,8,9,8,9,0,0,0,0,0,0,0,0,0,0,4,2,4,7
Kenedy,10,28,13,15,11,15,0,0,0,0,1,0,0,0,1,0,8,3,5,12
Kenedy,11,29,13,16,13,15,0,0,0,1,0,0,0,0,0,0,2,3,11,13
Kenedy,12,24,15,9,14,8,1,1,0,0,0,0,0,0,0,0,2,2,13,7
Kenedy,13,33,18,15,17,14,1,1,0,0,0,0,0,0,0,0,5,6,13,9
Kenedy,14,11,9,2,9,2,0,0,0,0,0,0,0,0,0,0,5,1,4,1
Kenedy,15,25,10,15,10,15,0,0,0,0,0,0,0,0,0,0,2,1,8,14
Kenedy,16,10,6,4,6,4,0,0,0,0,0,0,0,0,0,0,0,1,6,3
Kenedy,17,6,2,4,2,4,0,0,0,0,0,0,0,0,0,0,0,1,2,3
Kenedy,18,11,3,8,3,7,0,0,0,1,0,0,0,0,0,0,2,3,1,5
Kent,5,24,11,13,10,12,1,0,0,0,0,0,0,0,0,1,10,9,1,4
Kent,6,21,12,9,10,8,0,1,0,0,0,0,0,0,2,0,10,8,2,1
Kent,7,38,26,12,24,11,0,1,2,0,0,0,0,0,0,0,21,11,5,1
Kent,8,44,20,24,20,24,0,0,0,0,0,0,0,0,0,0,15,21,5,3
Kent,9,23,11,12,11,9,0,1,0,0,0,0,0,0,0,2,7,9,4,3
Kent,10,43,26,17,23,16,0,0,0,1,0,0,0,0,3,0,17,10,9,7
Kent,11,48,23,25,21,25,1,0,0,0,0,0,0,0,1,0,16,21,7,4
Kent,12,52,27,25,25,25,2,0,0,0,0,0,0,0,0,0,25,23,2,2
Kent,13,65,38,27,36,27,0,0,2,0,0,0,0,0,0,0,34,26,4,1
Kent,14,41,21,20,20,20,0,0,0,0,0,0,1,0,0,0,18,16,3,4
Kent,15,52,20,32,20,31,0,0,0,1,0,0,0,0,0,0,18,26,2,6
Kent,16,41,15,26,15,23,0,2,0,0,0,0,0,0,0,1,13,24,2,2
Kent,17,34,8,26,7,24,0,1,0,1,0,0,0,0,1,0,6,23,2,3
Kent,18,31,7,24,7,23,0,0,0,0,0,0,0,0,0,1,7,24,0,0
Kerr,5,2873,1479,1394,1342,1293,55,30,22,20,13,13,1,1,46,37,887,835,592,559
Kerr,6,2874,1405,1469,1257,1330,50,31,29,13,39,58,2,2,28,35,887,919,518,550
Kerr,7,2692,1317,1375,1219,1284,36,21,18,17,15,27,3,1,26,25,818,845,499,530
Kerr,8,2501,1208,1293,1129,1193,18,15,16,18,29,37,1,3,15,27,778,835,430,458
Kerr,9,2342,1174,1168,1093,1107,35,23,18,12,13,13,0,0,15,13,787,769,387,399
Kerr,10,2657,1226,1431,1135,1345,39,21,13,23,17,23,5,1,17,18,829,977,397,454
Kerr,11,3038,1456,1582,1347,1491,43,23,26,25,17,21,5,1,18,21,1043,1167,413,415
Kerr,12,3715,1714,2001,1599,1884,48,37,28,24,13,20,1,2,25,34,1325,1609,389,392
Kerr,13,3871,1824,2047,1728,1940,37,32,31,27,13,32,1,0,14,16,1511,1738,313,309
Kerr,14,4005,1863,2142,1785,2072,20,15,14,16,28,23,2,1,14,15,1646,1907,217,235
Kerr,15,3774,1758,2016,1703,1967,17,14,20,14,3,7,1,0,14,14,1572,1834,186,182
Kerr,16,2825,1342,1483,1308,1445,9,7,8,13,3,3,0,2,14,13,1223,1372,119,111
Kerr,17,1907,886,1021,852,992,16,5,5,7,1,6,2,0,10,11,834,931,52,90
Kerr,18,1933,819,1114,798,1081,6,6,7,10,4,4,0,0,4,13,769,1030,50,84
Kimble,5,197,87,110,84,110,1,0,0,0,0,0,0,0,2,0,54,82,33,28
Kimble,6,187,104,83,102,80,0,0,2,1,0,0,0,0,0,2,62,53,42,30
Kimble,7,208,120,88,110,86,6,1,0,0,4,1,0,0,0,0,80,60,40,28
Kimble,8,211,101,110,96,107,2,0,2,1,0,2,1,0,0,0,56,82,45,28
Kimble,9,198,87,111,79,104,0,0,2,2,4,5,0,0,2,0,51,72,36,39
Kimble,10,248,110,138,106,137,1,0,0,0,3,0,0,0,0,1,90,99,20,39
Kimble,11,244,128,116,123,111,0,1,3,1,1,1,0,1,1,1,89,92,39,24
Kimble,12,333,153,180,150,176,0,0,2,3,1,1,0,0,0,0,126,148,27,32
Kimble,13,387,200,187,187,182,3,1,7,1,2,0,0,1,1,2,173,161,27,26
Kimble,14,361,171,190,165,187,2,0,4,1,0,2,0,0,0,0,138,168,33,22
Kimble,15,356,168,188,162,183,0,0,4,1,0,1,0,0,2,3,146,169,22,19
Kimble,16,247,122,125,119,125,1,0,0,0,0,0,0,0,2,0,109,117,13,8
Kimble,17,170,85,85,83,84,1,0,0,1,0,0,0,0,1,0,78,78,7,7
Kimble,18,132,50,82,49,80,0,0,1,1,0,0,0,0,0,1,46,70,4,12
King,5,11,7,4,6,3,0,0,0,0,0,0,1,0,0,1,4,2,3,2
King,6,18,9,9,8,7,0,0,1,0,0,0,0,0,0,2,9,8,0,1
King,7,13,6,7,5,6,0,0,1,1,0,0,0,0,0,0,4,6,2,1
King,8,23,12,11,11,11,0,0,0,0,0,0,0,0,1,0,11,11,1,0
King,9,7,6,1,6,1,0,0,0,0,0,0,0,0,0,0,4,0,2,1
King,10,18,11,7,11,7,0,0,0,0,0,0,0,0,0,0,8,5,3,2
King,11,22,9,13,9,13,0,0,0,0,0,0,0,0,0,0,5,9,4,4
King,12,17,7,10,7,9,0,0,0,0,0,0,0,0,0,1,5,9,2,1
King,13,23,14,9,13,8,0,0,0,0,0,0,0,0,1,1,11,9,3,0
King,14,13,8,5,8,5,0,0,0,0,0,0,0,0,0,0,8,5,0,0
King,15,9,5,4,5,4,0,0,0,0,0,0,0,0,0,0,5,4,0,0
King,16,8,5,3,5,3,0,0,0,0,0,0,0,0,0,0,5,2,0,1
King,17,12,1,11,1,11,0,0,0,0,0,0,0,0,0,0,1,11,0,0
King,18,6,5,1,5,1,0,0,0,0,0,0,0,0,0,0,5,1,0,0
Kinney,5,259,164,95,156,84,2,3,1,2,2,0,0,0,3,6,18,24,146,71
Kinney,6,235,159,76,150,70,4,1,0,1,0,0,0,0,5,4,18,19,141,57
Kinney,7,225,154,71,150,69,1,2,1,0,1,0,1,0,0,0,19,13,135,58
Kinney,8,239,146,93,142,87,1,2,1,0,0,1,1,1,1,2,30,35,116,58
Kinney,9,216,126,90,122,84,3,3,0,1,0,1,0,0,1,1,30,32,96,58
Kinney,10,205,107,98,103,93,0,1,3,0,0,1,0,0,1,3,32,45,75,53
Kinney,11,208,114,94,106,88,5,1,1,4,1,0,0,0,1,1,39,35,75,59
Kinney,12,173,81,92,79,85,1,3,0,3,0,0,0,0,1,1,40,49,41,43
Kinney,13,252,130,122,119,109,3,4,5,5,2,1,0,0,1,3,61,64,69,58
Kinney,14,215,104,111,93,103,5,2,4,4,0,0,0,1,2,1,56,59,48,52
Kinney,15,222,111,111,105,107,4,2,2,2,0,0,0,0,0,0,76,70,35,41
Kinney,16,191,89,102,86,96,0,0,1,3,0,2,1,0,1,1,65,79,24,23
Kinney,17,152,61,91,56,88,3,0,1,1,1,1,0,0,0,1,47,62,14,29
Kinney,18,119,67,52,63,49,1,2,1,1,1,0,0,0,1,0,42,22,25,30
Kleberg,5,4662,2431,2231,1974,1976,166,105,16,7,252,73,2,2,21,68,806,522,1625,1709
Kleberg,6,2388,1313,1075,1160,1010,88,32,17,7,25,13,1,2,22,11,434,262,879,813
Kleberg,7,1883,1030,853,949,775,42,34,15,12,16,18,3,5,5,9,265,231,765,622
Kleberg,8,1826,981,845,894,784,30,27,13,10,20,11,2,4,22,9,237,185,744,660
Kleberg,9,1407,704,703,660,647,25,17,3,12,10,19,0,0,6,8,193,158,511,545
Kleberg,10,1526,766,760,709,703,24,24,10,5,14,18,2,1,7,9,199,191,567,569
Kleberg,11,1368,658,710,613,658,20,23,9,7,10,17,0,1,6,4,179,192,479,518
Kleberg,12,1348,681,667,629,627,24,18,11,5,12,10,1,0,4,7,236,212,445,455
Kleberg,13,1378,645,733,604,664,16,32,16,15,3,13,0,3,6,6,197,236,448,497
Kleberg,14,1132,550,582,512,542,17,14,5,10,8,10,2,1,6,5,185,185,365,397
Kleberg,15,1097,511,586,474,540,21,17,5,2,7,17,0,1,4,9,173,203,338,383
Kleberg,16,739,340,399,318,381,4,10,6,1,8,6,0,0,4,1,162,137,178,262
Kleberg,17,540,222,318,204,310,13,5,1,0,2,3,1,0,1,0,92,103,130,215
Kleberg,18,496,192,304,184,288,3,3,1,4,4,6,0,0,0,3,75,116,117,188
Knox,5,179,99,80,82,71,10,5,5,2,0,0,0,0,2,2,57,41,42,39
Knox,6,226,94,132,81,121,12,5,0,0,0,0,0,0,1,6,61,69,33,63
Knox,7,214,115,99,105,88,5,6,0,2,1,0,0,0,4,3,65,63,50,36
Knox,8,190,91,99,82,93,5,4,2,1,0,0,0,0,2,1,55,55,36,44
Knox,9,188,112,76,103,70,6,5,1,0,1,1,0,0,1,0,70,44,42,32
Knox,10,169,74,95,68,84,4,9,2,1,0,1,0,0,0,0,49,60,25,35
Knox,11,216,110,106,98,97,8,6,3,3,1,0,0,0,0,0,75,74,35,32
Knox,12,238,125,113,118,102,4,8,2,2,1,1,0,0,0,0,94,85,31,28
Knox,13,257,141,116,138,102,2,10,1,2,0,0,0,0,0,2,100,90,41,26
Knox,14,204,101,103,89,92,5,10,4,0,0,0,0,1,3,0,76,88,25,15
Knox,15,180,87,93,78,83,2,8,4,0,0,1,0,0,3,1,67,73,20,20
Knox,16,127,47,80,46,77,1,2,0,0,0,0,0,0,0,1,46,67,1,13
Knox,17,117,38,79,32,77,5,2,1,0,0,0,0,0,0,0,32,71,6,8
Knox,18,94,25,69,23,66,0,2,0,0,0,0,0,0,2,1,21,62,4,7
Lamar,5,2809,1393,1416,1041,1081,254,226,32,33,9,14,2,2,55,60,1211,1260,182,156
Lamar,6,3352,1637,1715,1296,1321,257,286,35,35,12,10,1,1,36,62,1497,1586,140,129
Lamar,7,2831,1398,1433,1132,1136,192,227,36,28,3,16,0,1,35,25,1263,1303,135,130
Lamar,8,2777,1304,1473,1077,1182,156,210,23,31,14,13,2,1,32,36,1174,1342,130,131
Lamar,9,2682,1286,1396,1069,1117,160,195,24,44,15,15,0,0,18,25,1142,1265,144,131
Lamar,10,3074,1451,1623,1199,1315,185,248,38,21,10,17,0,1,19,21,1322,1535,129,88
Lamar,11,3172,1550,1622,1296,1294,198,257,23,24,13,15,1,2,19,30,1475,1556,75,66
Lamar,12,3357,1598,1759,1356,1468,192,224,18,35,9,13,0,0,23,19,1541,1708,57,51
Lamar,13,3132,1507,1625,1278,1305,172,248,23,25,10,14,0,0,24,33,1450,1585,57,40
Lamar,14,2886,1338,1548,1155,1312,136,175,20,33,8,12,1,1,18,15,1294,1519,44,29
Lamar,15,2517,1177,1340,1064,1179,81,113,11,17,7,10,0,1,14,20,1151,1314,26,26
Lamar,16,1852,817,1035,758,920,40,96,7,6,2,5,0,0,10,8,803,1021,14,14
Lamar,17,1172,482,690,444,613,24,54,7,6,2,6,0,0,5,11,475,685,7,5
Lamar,18,1181,405,776,358,692,34,64,10,8,1,2,0,0,2,10,390,757,15,19
Lamb,5,759,413,346,381,321,11,11,11,6,1,1,0,0,9,7,153,125,260,221
Lamb,6,781,404,377,375,345,12,15,7,4,2,4,0,0,8,9,137,146,267,231
Lamb,7,763,382,381,345,335,9,19,8,14,5,1,6,4,9,8,126,127,256,254
Lamb,8,794,397,397,362,370,19,17,9,7,2,0,0,0,5,3,155,146,242,251
Lamb,9,732,360,372,328,335,17,22,13,9,0,0,0,1,2,5,145,166,215,206
Lamb,10,652,327,325,313,312,6,6,2,3,0,1,0,0,6,3,124,127,203,198
Lamb,11,774,385,389,347,355,26,19,5,10,1,3,0,0,6,2,161,165,224,224
Lamb,12,832,393,439,364,389,20,25,6,11,1,5,0,1,2,8,238,253,155,186
Lamb,13,804,417,387,383,349,23,23,7,7,2,1,0,0,2,7,259,250,158,137
Lamb,14,633,308,325,290,311,11,10,4,2,0,2,0,0,3,0,205,202,103,123
Lamb,15,465,218,247,203,230,9,9,2,2,1,2,0,1,3,3,137,148,81,99
Lamb,16,408,182,226,169,215,5,7,5,1,0,0,0,0,3,3,126,159,56,67
Lamb,17,371,161,210,156,202,4,4,0,3,0,0,0,0,1,1,117,160,44,50
Lamb,18,323,117,206,108,193,5,9,2,2,0,1,0,0,2,1,91,169,26,37
Lampasas,5,1051,553,498,477,427,31,32,8,10,11,8,5,1,21,20,411,351,142,147
Lampasas,6,1065,544,521,478,474,22,17,11,7,11,5,1,1,21,17,381,385,163,136
Lampasas,7,1137,571,566,535,519,20,22,2,6,2,5,3,6,9,8,418,444,153,122
Lampasas,8,1277,636,641,567,593,39,18,5,7,5,7,2,1,18,15,463,515,173,126
Lampasas,9,1281,635,646,566,576,32,31,6,8,7,11,11,3,13,17,507,513,128,133
Lampasas,10,1340,672,668,591,621,47,16,12,8,7,12,1,2,14,9,563,543,109,125
Lampasas,11,1566,789,777,708,704,57,36,11,11,4,9,2,1,7,16,661,658,128,119
Lampasas,12,1593,817,776,739,712,34,26,8,6,18,17,2,2,16,13,677,678,140,98
Lampasas,13,1526,720,806,657,719,36,33,7,9,5,23,3,3,12,19,626,723,94,83
Lampasas,14,1292,590,702,542,647,29,9,4,15,5,21,1,2,9,8,530,632,60,70
Lampasas,15,1128,541,587,515,545,12,10,4,7,4,14,0,1,6,10,493,544,48,43
Lampasas,16,772,356,416,332,388,14,10,4,2,2,11,3,0,1,5,323,380,33,36
Lampasas,17,490,217,273,204,254,3,8,2,0,2,2,2,0,4,9,202,248,15,25
Lampasas,18,465,198,267,187,257,2,1,3,1,1,6,0,0,5,2,176,247,22,20
La,5,1071,852,219,838,211,3,5,8,2,1,1,0,0,2,0,34,11,818,208
La,6,861,637,224,629,215,1,6,4,1,0,2,0,0,3,0,40,30,597,194
La,7,509,284,225,268,221,5,1,8,2,0,0,0,0,3,1,29,27,255,198
La,8,442,262,180,254,176,3,1,3,2,0,0,0,0,2,1,23,25,239,155
La,9,469,281,188,275,184,0,1,1,1,3,2,0,0,2,0,30,25,251,163
La,10,409,225,184,219,179,5,2,1,1,0,2,0,0,0,0,39,17,186,167
La,11,409,211,198,209,194,2,1,0,2,0,0,0,0,0,1,34,28,177,170
La,12,319,161,158,152,153,7,1,0,0,1,1,0,0,1,3,28,29,133,129
La,13,297,130,167,125,155,2,8,3,0,0,2,0,0,0,2,23,23,107,144
La,14,298,145,153,135,141,3,6,3,1,4,1,0,1,0,3,30,35,115,118
La,15,290,130,160,126,157,1,1,1,1,1,1,0,0,1,0,44,43,86,117
La,16,185,92,93,88,91,2,0,1,1,0,1,0,0,1,0,29,22,63,71
La,17,138,54,84,50,83,3,0,0,0,0,0,0,1,1,0,14,16,40,68
La,18,104,44,60,43,56,0,1,1,3,0,0,0,0,0,0,19,35,25,25
Lavaca,5,1030,541,489,473,438,46,39,7,3,2,1,3,0,10,8,404,351,137,138
Lavaca,6,1055,537,518,472,466,43,35,6,3,1,3,1,2,14,9,406,387,131,131
Lavaca,7,992,470,522,437,467,20,36,1,7,6,6,0,0,6,6,344,387,126,135
Lavaca,8,1093,528,565,486,512,31,40,1,1,4,3,1,1,5,8,413,420,115,145
Lavaca,9,985,507,478,457,423,37,36,2,5,3,5,0,1,8,8,397,376,110,102
Lavaca,10,1097,532,565,487,530,33,25,6,2,2,6,0,0,4,2,409,467,123,98
Lavaca,11,1182,626,556,593,514,20,27,3,6,7,3,0,1,3,5,538,484,88,72
Lavaca,12,1403,721,682,668,640,42,32,3,2,2,4,1,0,5,4,635,614,86,68
Lavaca,13,1388,630,758,599,703,24,42,2,5,3,1,0,2,2,5,568,676,62,82
Lavaca,14,1434,710,724,661,658,41,55,5,3,1,4,1,0,1,4,651,666,59,58
Lavaca,15,1098,496,602,464,552,24,39,1,5,0,2,0,1,7,3,460,564,36,38
Lavaca,16,797,379,418,352,387,24,23,0,2,0,2,0,1,3,3,354,387,25,31
Lavaca,17,625,265,360,251,318,12,24,2,3,0,13,0,0,0,2,250,335,15,25
Lavaca,18,735,244,491,236,472,6,17,1,1,1,1,0,0,0,0,218,470,26,21
Lee,5,926,486,440,392,378,72,41,8,8,1,2,4,0,9,11,324,270,162,170
Lee,6,983,490,493,395,426,71,53,6,5,4,2,4,1,10,6,337,315,153,178
Lee,7,999,489,510,432,445,47,47,8,6,1,7,0,0,1,5,327,363,162,147
Lee,8,1057,547,510,472,457,55,37,6,4,9,6,0,1,5,5,405,364,142,146
Lee,9,981,474,507,421,450,38,41,4,1,6,6,3,1,2,8,372,397,102,110
Lee,10,1004,491,513,421,444,59,54,3,5,3,3,3,2,2,5,392,402,99,111
Lee,11,1100,529,571,457,486,62,67,3,9,3,1,0,2,4,6,414,445,115,126
Lee,12,1378,692,686,585,584,85,84,10,10,3,2,1,1,8,5,584,592,108,94
Lee,13,1339,678,661,591,582,70,66,11,6,1,2,1,0,4,5,588,593,90,68
Lee,14,1014,519,495,447,418,60,61,4,6,4,3,1,0,3,7,470,463,49,32
Lee,15,771,395,376,356,345,32,27,2,2,2,0,0,0,3,2,361,358,34,18
Lee,16,600,280,320,248,277,26,35,2,3,1,1,0,1,3,3,261,298,19,22
Lee,17,403,165,238,137,203,21,30,5,5,0,0,0,0,2,0,153,217,12,21
Lee,18,346,132,214,111,183,20,29,1,1,0,0,0,0,0,1,126,208,6,6
Leon,5,810,433,377,392,330,29,31,2,4,3,5,1,0,6,7,341,310,92,67
Leon,6,846,417,429,375,395,23,19,3,2,6,6,0,0,10,7,326,345,91,84
Leon,7,808,398,410,368,368,18,29,3,3,3,6,0,0,6,4,295,343,103,67
Leon,8,900,434,466,394,419,26,30,3,4,4,4,0,0,7,9,338,383,96,83
Leon,9,920,460,460,420,411,34,33,5,5,0,6,0,0,1,5,373,387,87,73
Leon,10,885,456,429,393,378,49,35,4,5,5,7,0,0,5,4,378,379,78,50
Leon,11,987,477,510,416,465,47,29,5,5,6,5,0,1,3,5,412,443,65,67
Leon,12,1277,633,644,574,572,37,49,6,8,5,9,0,1,11,5,561,586,72,58
Leon,13,1350,659,691,582,627,67,51,4,3,4,2,0,0,2,8,611,644,48,47
Leon,14,1245,605,640,541,566,50,52,6,10,2,3,1,0,5,9,576,613,29,27
Leon,15,1125,541,584,512,530,20,43,1,1,1,4,0,0,7,6,510,561,31,23
Leon,16,891,434,457,399,424,29,29,2,1,1,0,0,0,3,3,419,450,15,7
Leon,17,513,249,264,225,239,21,20,1,2,1,1,0,0,1,2,242,259,7,5
Leon,18,456,172,284,163,232,8,43,1,2,0,0,0,0,0,7,165,276,7,8
Liberty,5,5599,2816,2783,2394,2309,310,373,33,39,16,16,5,8,58,38,1853,1874,963,909
Liberty,6,6338,3128,3210,2635,2673,372,423,45,59,24,24,1,2,51,29,2219,2351,909,859
Liberty,7,5819,2856,2963,2436,2517,324,347,36,26,26,22,4,2,30,49,1958,2108,898,855
Liberty,8,5496,2670,2826,2300,2429,271,311,29,30,24,29,1,3,45,24,1807,2039,863,787
Liberty,9,5260,2456,2804,2123,2386,261,316,28,29,12,26,5,6,27,41,1739,2023,717,781
Liberty,10,5676,2771,2905,2437,2485,245,336,39,34,22,20,5,2,23,28,2118,2271,653,634
Liberty,11,5291,2693,2598,2370,2223,245,309,41,26,14,14,4,1,19,25,2074,2113,619,485
Liberty,12,5559,2773,2786,2462,2409,260,303,19,33,11,15,1,3,20,23,2263,2410,510,376
Liberty,13,4792,2373,2419,2042,2102,264,241,25,22,16,13,1,2,25,39,2072,2132,301,287
Liberty,14,3961,1955,2006,1703,1741,201,213,20,25,8,9,0,0,23,18,1732,1833,223,173
Liberty,15,2994,1449,1545,1307,1400,105,110,14,10,8,4,0,0,15,21,1318,1434,131,111
Liberty,16,1965,901,1064,806,933,67,103,6,12,2,7,0,0,20,9,849,1010,52,54
Liberty,17,1099,468,631,401,555,52,66,8,2,1,3,0,2,6,3,432,610,36,21
Liberty,18,1023,376,647,320,572,48,61,4,5,0,1,0,0,4,8,342,619,34,28
Limestone,5,1405,828,577,610,412,180,122,8,10,10,18,1,1,19,14,577,401,251,176
Limestone,6,1534,865,669,669,509,171,135,9,5,6,5,2,0,8,15,615,495,250,174
Limestone,7,1430,812,618,628,454,153,134,14,14,5,8,0,0,12,8,560,460,252,158
Limestone,8,1368,749,619,577,477,145,124,11,8,6,4,0,1,10,5,530,450,219,169
Limestone,9,1320,697,623,529,485,145,113,11,13,5,8,1,1,6,3,515,471,182,152
Limestone,10,1316,659,657,516,514,120,127,7,4,8,6,1,0,7,6,512,550,147,107
Limestone,11,1377,682,695,517,550,121,130,33,6,6,4,1,1,4,4,527,568,155,127
Limestone,12,1631,807,824,661,658,132,148,5,5,3,4,0,1,6,8,687,715,120,109
Limestone,13,1637,795,842,660,661,119,160,6,9,2,6,0,0,8,6,702,787,93,55
Limestone,14,1440,668,772,541,640,105,115,5,6,6,2,1,0,10,9,617,710,51,62
Limestone,15,1218,592,626,533,535,46,81,6,2,1,2,0,0,6,6,542,596,50,30
Limestone,16,833,384,449,347,384,30,54,2,3,1,1,1,0,3,7,371,431,13,18
Limestone,17,505,223,282,192,242,25,35,2,1,0,0,0,0,4,4,217,274,6,8
Limestone,18,555,212,343,192,285,18,45,2,4,0,7,0,0,0,2,196,326,16,17
Lipscomb,5,176,93,83,86,72,1,4,2,3,1,2,0,1,3,1,57,51,36,32
Lipscomb,6,174,98,76,88,66,7,0,2,3,1,1,0,0,0,6,55,55,43,21
Lipscomb,7,233,134,99,120,92,6,1,4,1,0,2,1,1,3,2,60,57,74,42
Lipscomb,8,248,159,89,149,83,7,3,1,2,0,0,0,0,2,1,77,50,82,39
Lipscomb,9,161,67,94,62,86,3,0,1,3,0,0,0,1,1,4,42,59,25,35
Lipscomb,10,161,88,73,75,65,6,0,5,1,1,3,0,0,1,4,45,49,43,24
Lipscomb,11,190,97,93,93,86,0,0,0,5,1,1,0,0,3,1,63,67,34,26
Lipscomb,12,246,125,121,118,115,2,1,2,3,0,0,0,0,3,2,105,99,20,22
Lipscomb,13,217,106,111,99,102,0,1,4,5,0,2,1,0,2,1,87,97,19,14
Lipscomb,14,205,114,91,112,86,2,0,0,3,0,0,0,0,0,2,101,84,13,7
Lipscomb,15,115,56,59,55,58,0,0,0,0,0,1,0,0,1,0,52,53,4,6
Lipscomb,16,109,44,65,40,62,0,0,2,1,0,0,0,0,2,2,40,60,4,5
Lipscomb,17,82,36,46,36,45,0,0,0,0,0,0,0,0,0,1,33,44,3,2
Lipscomb,18,95,32,63,30,62,0,0,0,0,0,1,0,0,2,0,29,58,3,5
Live,5,677,409,268,334,257,52,5,11,2,6,3,1,1,5,0,204,123,205,145
Live,6,856,534,322,407,304,99,6,14,5,6,4,1,1,7,2,302,171,232,151
Live,7,884,593,291,436,275,137,5,9,5,6,1,0,0,5,5,308,155,285,136
Live,8,803,503,300,393,296,85,1,7,2,12,0,2,0,4,1,297,165,206,135
Live,9,701,413,288,329,278,64,3,11,3,6,2,0,0,3,2,232,168,181,120
Live,10,637,359,278,322,264,29,2,1,2,4,5,1,0,2,5,203,175,156,103
Live,11,704,369,335,345,325,17,1,1,3,2,2,0,0,4,4,203,219,166,116
Live,12,915,476,439,457,426,15,2,1,9,3,2,0,0,0,0,326,307,150,132
Live,13,813,398,415,379,406,6,0,7,3,3,3,0,0,3,3,272,284,126,131
Live,14,735,364,371,351,363,2,2,3,1,2,1,0,3,6,1,271,261,93,110
Live,15,635,318,317,307,304,1,1,4,4,1,3,0,0,5,5,243,223,75,94
Live,16,490,270,220,265,212,0,1,2,5,1,0,0,0,2,2,205,172,65,48
Live,17,345,165,180,159,176,0,0,4,4,0,0,0,0,2,0,121,125,44,55
Live,18,300,112,188,103,185,1,1,5,1,0,0,0,0,3,1,83,131,29,57
Llano,5,839,422,417,394,387,5,12,9,4,2,6,1,0,11,8,323,335,99,82
Llano,6,884,442,442,412,419,15,10,6,6,0,3,0,0,9,4,344,361,98,81
Llano,7,812,409,403,375,386,15,8,5,5,3,3,1,0,10,1,330,335,79,68
Llano,8,858,451,407,420,376,12,8,6,8,3,8,1,0,9,7,373,327,78,80
Llano,9,811,391,420,375,398,4,4,1,8,6,7,1,0,4,3,340,356,51,64
Llano,10,1062,504,558,463,532,14,8,8,6,10,5,0,1,9,6,459,490,45,68
Llano,11,1199,559,640,533,605,13,11,6,8,2,6,0,0,5,10,493,567,66,73
Llano,12,1643,766,877,743,852,7,10,6,3,1,3,0,2,9,7,698,796,68,81
Llano,13,2036,943,1093,912,1063,13,5,7,12,3,3,0,0,8,10,902,1032,41,61
Llano,14,2225,1038,1187,1023,1163,2,3,7,5,1,5,0,0,5,11,998,1149,40,38
Llano,15,2037,975,1062,959,1036,3,3,7,10,4,5,0,1,2,7,952,1030,23,32
Llano,16,1508,764,744,754,732,0,1,5,5,2,4,0,0,3,2,752,731,12,13
Llano,17,1067,531,536,519,529,7,1,1,2,0,1,0,0,4,3,516,515,15,21
Llano,18,981,406,575,400,563,2,3,0,3,0,1,0,0,4,5,396,569,10,6
Loving,5,9,5,4,5,4,0,0,0,0,0,0,0,0,0,0,4,4,1,0
Loving,6,14,8,6,8,6,0,0,0,0,0,0,0,0,0,0,5,6,3,0
Loving,7,13,5,8,5,7,0,1,0,0,0,0,0,0,0,0,4,6,1,2
Loving,8,12,6,6,6,4,0,2,0,0,0,0,0,0,0,0,6,4,0,2
Loving,9,2,1,1,1,1,0,0,0,0,0,0,0,0,0,0,1,1,0,0
Loving,10,2,1,1,1,1,0,0,0,0,0,0,0,0,0,0,1,0,0,1
Loving,11,7,4,3,4,2,0,0,0,1,0,0,0,0,0,0,2,2,2,1
Loving,12,7,4,3,4,3,0,0,0,0,0,0,0,0,0,0,3,2,1,1
Loving,13,13,10,3,10,3,0,0,0,0,0,0,0,0,0,0,8,3,2,0
Loving,14,7,3,4,3,4,0,0,0,0,0,0,0,0,0,0,3,4,0,0
Loving,15,5,4,1,4,1,0,0,0,0,0,0,0,0,0,0,4,1,0,0
Loving,16,3,1,2,1,2,0,0,0,0,0,0,0,0,0,0,1,1,0,1
Loving,17,0,0,0,0,0,0,0,0,0,0,0,0,0,0,0,0,0,0,0
Loving,18,0,0,0,0,0,0,0,0,0,0,0,0,0,0,0,0,0,0,0
Lubbock,5,37771,19540,18231,16731,15908,1446,1272,224,169,688,532,16,20,435,330,13498,12234,6042,5997
Lubbock,6,24764,12684,12080,10741,10307,1135,1024,140,159,425,317,18,17,225,256,7788,7325,4896,4755
Lubbock,7,20484,10351,10133,8854,8669,867,806,115,151,316,305,17,16,182,186,6249,6107,4102,4026
Lubbock,8,19922,9985,9937,8664,8630,770,759,127,123,291,266,7,12,126,147,6087,6112,3898,3825
Lubbock,9,16410,8094,8316,7083,7139,536,624,115,109,255,319,10,15,95,110,4990,5169,3104,3147
Lubbock,10,15597,7481,8116,6551,7049,512,607,85,92,238,279,17,15,78,74,4897,5160,2584,2956
Lubbock,11,15198,7362,7836,6497,6901,547,595,76,90,169,158,7,8,66,84,4853,5174,2509,2662
Lubbock,12,16398,7887,8511,6946,7503,595,681,105,96,159,153,8,6,74,72,5529,6039,2358,2472
Lubbock,13,15623,7368,8255,6632,7365,466,582,79,67,119,153,15,12,57,76,5441,6158,1927,2097
Lubbock,14,12361,5797,6564,5215,5921,377,415,58,47,85,129,1,8,61,44,4517,5115,1280,1449
Lubbock,15,9502,4328,5174,3960,4745,242,274,38,33,51,79,3,7,34,36,3369,4046,959,1128
Lubbock,16,6704,2839,3865,2600,3516,147,213,24,26,48,75,2,2,18,33,2360,3211,479,654
Lubbock,17,4893,2009,2884,1869,2695,85,116,18,26,19,33,1,3,17,11,1579,2351,430,533
Lubbock,18,4690,1660,3030,1543,2813,67,160,27,18,14,23,1,4,8,12,1435,2563,225,467
Lynn,5,301,150,151,131,134,7,5,6,3,2,2,0,0,4,7,61,71,89,80
Lynn,6,356,202,154,182,146,9,2,4,1,1,0,0,0,6,5,99,87,103,67
Lynn,7,362,196,166,184,160,7,3,1,1,2,0,0,0,2,2,90,76,106,90
Lynn,8,369,185,184,172,177,10,4,3,0,0,2,0,0,0,1,81,99,104,85
Lynn,9,347,183,164,178,152,1,4,2,6,1,1,0,0,1,1,86,96,97,68
Lynn,10,268,130,138,116,129,4,4,8,3,1,1,0,0,1,1,68,69,62,69
Lynn,11,383,182,201,167,187,6,6,4,3,1,2,0,0,4,3,94,115,88,86
Lynn,12,402,213,189,199,177,4,6,6,3,1,0,0,0,3,3,116,109,97,80
Lynn,13,365,195,170,182,161,9,3,2,5,0,0,0,0,2,1,125,110,70,60
Lynn,14,273,147,126,144,116,1,3,1,5,0,0,0,0,1,2,96,81,51,45
Lynn,15,233,114,119,103,114,2,3,7,1,0,0,0,0,2,1,69,84,45,35
Lynn,16,198,85,113,81,107,3,3,1,3,0,0,0,0,0,0,57,85,28,28
Lynn,17,168,69,99,65,92,1,4,1,0,0,1,0,0,2,2,49,64,20,35
Lynn,18,109,48,61,47,54,0,3,1,3,0,0,0,0,0,1,35,42,13,19
McCulloch,5,444,226,218,196,200,24,10,1,3,1,1,0,0,4,4,127,125,99,93
McCulloch,6,451,234,217,212,205,10,4,3,1,3,1,1,0,5,6,126,128,108,89
McCulloch,7,416,224,192,203,178,8,4,2,4,2,1,2,0,7,5,134,123,90,69
McCulloch,8,426,220,206,202,190,6,4,5,2,4,6,0,0,3,4,130,134,90,72
McCulloch,9,450,233,217,223,205,4,6,2,1,3,4,0,0,1,1,143,156,90,61
McCulloch,10,409,199,210,189,194,3,10,2,5,4,0,0,0,1,1,141,141,58,69
McCulloch,11,511,241,270,229,259,4,8,7,1,1,2,0,0,0,0,181,188,60,82
McCulloch,12,510,257,253,235,243,10,2,6,4,3,3,0,0,3,1,178,187,79,66
McCulloch,13,610,281,329,265,313,8,7,3,6,3,0,0,0,2,3,205,253,76,76
McCulloch,14,506,247,259,231,249,7,5,5,1,0,1,0,1,4,2,202,208,45,51
McCulloch,15,492,249,243,244,235,3,4,0,0,0,0,0,0,2,4,200,190,49,53
McCulloch,16,320,152,168,145,158,4,3,1,2,0,2,0,0,2,3,124,145,28,23
McCulloch,17,229,97,132,95,129,1,0,1,1,0,0,0,0,0,2,74,102,23,30
McCulloch,18,241,96,145,87,136,4,1,0,1,0,0,0,0,5,7,79,125,17,20
McLennan,5,26056,13119,12937,10452,10092,1925,1978,123,175,356,393,17,14,246,285,9714,9588,3405,3349
McLennan,6,17635,8876,8759,6885,6725,1443,1503,124,136,238,172,13,15,173,208,6228,6205,2648,2554
McLennan,7,15955,7856,8099,6349,6377,1092,1304,105,90,170,181,21,9,119,138,5417,5692,2439,2407
McLennan,8,15567,7548,8019,6225,6327,988,1341,76,87,141,138,10,15,108,111,5197,5772,2351,2247
McLennan,9,13580,6661,6919,5483,5443,897,1150,89,71,117,148,8,10,67,97,4649,5001,2012,1918
McLennan,10,13688,6689,6999,5508,5629,888,1045,85,79,136,147,5,8,67,91,4921,5260,1768,1739
McLennan,11,13568,6389,7179,5270,5782,867,1116,104,101,87,119,2,5,59,56,4870,5602,1519,1577
McLennan,12,14720,7175,7545,5896,6189,1041,1119,76,62,83,101,11,7,68,67,5727,6173,1448,1372
McLennan,13,13809,6561,7248,5526,5843,837,1188,59,61,70,86,6,2,63,68,5468,6206,1093,1042
McLennan,14,11696,5489,6207,4703,5163,655,871,50,42,34,79,4,4,43,48,4728,5430,761,777
McLennan,15,9012,4065,4947,3530,4219,427,560,29,31,47,86,1,8,31,43,3593,4398,472,549
McLennan,16,6251,2744,3507,2394,3012,267,418,29,25,38,31,0,1,16,20,2454,3154,290,353
McLennan,17,4609,1913,2696,1699,2331,184,306,13,21,11,26,1,0,5,12,1723,2433,190,263
McLennan,18,5003,1713,3290,1518,2900,172,345,10,13,9,13,0,2,4,17,1527,3013,186,277
McMullen,5,31,19,12,16,11,1,1,0,0,0,0,0,0,2,0,9,4,10,8
McMullen,6,44,29,15,24,14,1,1,1,0,0,0,0,0,3,0,12,10,17,5
McMullen,7,39,19,20,19,20,0,0,0,0,0,0,0,0,0,0,8,10,11,10
McMullen,8,35,15,20,13,15,2,1,0,0,0,2,0,0,0,2,7,12,8,8
McMullen,9,32,18,14,18,14,0,0,0,0,0,0,0,0,0,0,11,8,7,6
McMullen,10,48,27,21,25,20,1,1,0,0,0,0,0,0,1,0,11,11,16,10
McMullen,11,59,32,27,27,22,1,1,1,2,0,2,0,0,3,0,16,15,16,12
McMullen,12,51,22,29,22,28,0,1,0,0,0,0,0,0,0,0,12,17,10,12
McMullen,13,61,33,28,30,26,2,1,0,0,0,0,0,0,1,1,21,19,12,9
McMullen,14,40,24,16,24,16,0,0,0,0,0,0,0,0,0,0,14,11,10,5
McMullen,15,41,21,20,21,20,0,0,0,0,0,0,0,0,0,0,15,12,6,8
McMullen,16,35,23,12,23,12,0,0,0,0,0,0,0,0,0,0,13,8,10,4
McMullen,17,35,13,22,12,22,1,0,0,0,0,0,0,0,0,0,9,20,4,2
McMullen,18,27,13,14,11,13,0,1,0,0,0,0,0,0,2,0,11,13,2,1
Madison,5,1272,909,363,573,270,305,76,5,6,9,5,1,1,16,5,612,259,297,104
Madison,6,1384,993,391,624,311,339,67,13,7,6,1,2,0,9,5,648,294,345,97
Madison,7,1157,820,337,535,277,262,48,7,5,10,0,0,1,6,6,590,264,230,73
Madison,8,975,625,350,415,261,198,72,4,2,2,5,0,1,6,9,441,256,184,94
Madison,9,870,541,329,411,262,109,52,8,6,7,4,0,0,6,5,400,254,141,75
Madison,10,789,440,349,350,295,69,44,7,2,6,5,1,0,7,3,329,270,111,79
Madison,11,751,383,368,296,308,64,52,10,2,3,0,0,0,10,6,297,310,86,58
Madison,12,734,345,389,281,326,54,53,6,6,1,2,0,0,3,2,292,340,53,49
Madison,13,754,392,362,332,289,45,60,6,3,7,6,0,0,2,4,342,325,50,37
Madison,14,671,310,361,265,295,39,55,4,6,2,2,0,0,0,3,292,333,18,28
Madison,15,548,273,275,235,235,29,31,4,4,3,0,0,0,2,5,246,265,27,10
Madison,16,443,209,234,180,200,23,28,1,2,0,0,0,0,5,4,199,220,10,14
Madison,17,286,127,159,121,132,5,25,0,0,0,0,0,0,1,2,118,148,9,11
Madison,18,271,96,175,90,140,6,33,0,0,0,0,0,0,0,2,92,169,4,6
Marion,5,437,234,203,160,119,54,72,7,2,5,3,0,0,8,7,216,193,18,10
Marion,6,451,242,209,175,152,58,51,2,2,5,1,0,0,2,3,225,199,17,10
Marion,7,475,230,245,164,186,56,51,2,5,4,1,1,0,3,2,214,216,16,29
Marion,8,497,226,271,169,192,49,67,3,3,0,3,0,2,5,4,221,254,5,17
Marion,9,477,248,229,193,172,45,45,1,3,3,4,1,0,5,5,232,221,16,8
Marion,10,554,253,301,204,219,42,65,2,3,3,9,0,0,2,5,236,286,17,15
Marion,11,699,328,371,258,270,55,85,7,6,5,5,0,0,3,5,316,364,12,7
Marion,12,892,410,482,314,352,74,113,8,8,1,4,0,0,13,5,408,467,2,15
Marion,13,840,403,437,301,322,81,94,5,10,1,1,0,2,15,8,396,429,7,8
Marion,14,813,401,412,316,303,74,95,6,4,1,4,0,0,4,6,394,408,7,4
Marion,15,710,339,371,290,304,42,57,2,5,1,1,0,0,4,4,334,365,5,6
Marion,16,534,259,275,205,219,50,49,1,4,0,0,0,0,3,3,257,269,2,6
Marion,17,305,141,164,120,123,17,37,0,0,0,0,0,0,4,4,138,162,3,2
Marion,18,265,119,146,97,96,19,45,3,1,0,0,0,0,0,4,118,144,1,2
Martin,5,324,162,162,153,152,2,6,2,3,0,1,0,0,5,0,80,71,82,91
Martin,6,376,190,186,176,170,6,7,3,5,0,1,0,0,5,3,103,88,87,98
Martin,7,433,222,211,203,201,7,4,4,2,1,1,2,0,5,3,105,88,117,123
Martin,8,357,193,164,183,160,7,3,2,0,0,0,0,0,1,1,97,92,96,72
Martin,9,283,153,130,148,124,4,6,0,0,1,0,0,0,0,0,76,62,77,68
Martin,10,352,179,173,170,168,8,4,0,0,0,0,0,1,1,0,94,99,85,74
Martin,11,328,158,170,144,164,7,2,2,3,1,0,0,0,4,1,90,92,68,78
Martin,12,352,177,175,163,163,5,1,7,9,1,2,0,0,1,0,104,110,73,65
Martin,13,317,155,162,148,158,2,1,2,0,3,1,0,0,0,2,106,110,49,52
Martin,14,193,96,97,87,90,2,2,4,2,2,0,0,0,1,3,65,68,31,29
Martin,15,184,83,101,77,95,3,1,1,0,0,3,0,0,2,2,60,60,23,41
Martin,16,107,45,62,43,61,1,0,1,0,0,1,0,0,0,0,28,44,17,18
Martin,17,86,47,39,46,39,0,0,1,0,0,0,0,0,0,0,35,25,12,14
Martin,18,72,35,37,34,35,0,0,0,1,0,0,0,0,1,1,28,37,7,0
Mason,5,191,94,97,89,89,1,4,2,3,2,0,0,0,0,1,53,68,41,29
Mason,6,181,104,77,95,74,1,2,2,0,0,0,4,1,2,0,49,52,55,25
Mason,7,190,107,83,104,83,0,0,1,0,0,0,2,0,0,0,63,50,44,33
Mason,8,222,101,121,99,117,0,2,2,0,0,1,0,0,0,1,68,92,33,29
Mason,9,184,88,96,86,89,1,1,1,0,0,2,0,0,0,4,65,66,23,30
Mason,10,213,95,118,91,108,1,2,0,2,1,0,0,0,2,6,78,83,17,35
Mason,11,258,129,129,123,120,3,2,3,3,0,1,0,2,0,1,89,89,40,40
Mason,12,301,168,133,161,131,3,0,1,0,0,1,2,0,1,1,124,99,44,34
Mason,13,329,162,167,159,167,2,0,1,0,0,0,0,0,0,0,125,134,37,33
Mason,14,334,156,178,156,177,0,0,0,1,0,0,0,0,0,0,134,162,22,16
Mason,15,337,167,170,165,168,0,0,1,0,0,0,0,0,1,2,152,148,15,22
Mason,16,260,127,133,124,131,0,0,1,1,0,1,0,0,2,0,113,128,14,5
Mason,17,167,76,91,74,89,0,0,0,1,0,0,0,0,2,1,67,82,9,9
Mason,18,126,57,69,57,66,0,0,0,2,0,0,0,0,0,1,49,67,8,2
Matagorda,5,2158,1138,1020,921,825,156,143,15,16,25,22,2,1,19,13,526,467,612,553
Matagorda,6,2388,1248,1140,1022,944,166,139,20,20,20,17,1,1,19,19,620,591,628,549
Matagorda,7,2204,1094,1110,937,953,108,105,15,20,21,11,2,3,11,18,524,588,570,522
Matagorda,8,2263,1202,1061,1043,881,98,121,20,17,20,22,2,2,19,18,532,568,670,493
Matagorda,9,1886,926,960,767,823,101,99,24,7,22,19,1,0,11,12,464,503,462,457
Matagorda,10,1965,932,1033,811,884,74,97,12,17,27,29,0,2,8,4,526,578,406,455
Matagorda,11,2167,1085,1082,904,879,120,154,18,15,28,24,3,2,12,8,639,687,446,395
Matagorda,12,2630,1285,1345,1088,1101,135,186,20,19,27,29,2,1,13,9,900,943,385,402
Matagorda,13,2456,1276,1180,1080,967,145,166,15,11,19,23,3,0,14,13,937,891,339,289
Matagorda,14,2112,1093,1019,960,868,93,99,7,9,18,27,1,1,14,15,827,773,266,246
Matagorda,15,1535,740,795,631,696,86,78,7,6,9,6,1,0,6,9,598,616,142,179
Matagorda,16,1095,531,564,464,503,49,50,4,4,9,4,0,0,5,3,436,434,95,130
Matagorda,17,771,361,410,317,332,32,61,3,5,6,8,0,0,3,4,291,325,70,85
Matagorda,18,709,240,469,200,376,29,77,3,1,4,12,0,0,4,3,206,398,34,71
Maverick,5,4776,2652,2124,2579,2070,21,11,36,30,11,6,0,0,5,7,95,68,2557,2056
Maverick,6,4325,2356,1969,2258,1904,39,19,40,23,10,13,4,2,5,8,116,79,2240,1890
Maverick,7,3655,1981,1674,1893,1602,14,9,47,47,13,14,0,1,14,1,107,99,1874,1575
Maverick,8,3388,1677,1711,1615,1630,17,9,21,42,10,24,2,2,12,4,104,98,1573,1613
Maverick,9,3352,1614,1738,1526,1680,9,5,34,23,36,20,2,1,7,9,109,81,1505,1657
Maverick,10,3413,1585,1828,1535,1788,9,3,26,26,11,8,0,1,4,2,78,76,1507,1752
Maverick,11,3010,1457,1553,1410,1512,5,7,19,23,19,9,0,0,4,2,79,73,1378,1480
Maverick,12,2730,1292,1438,1249,1402,13,5,19,17,5,11,1,0,5,3,77,50,1215,1388
Maverick,13,2524,1160,1364,1123,1331,12,5,13,15,8,10,0,0,4,3,56,75,1104,1289
Maverick,14,2236,1048,1188,1026,1163,5,3,11,15,3,2,0,0,3,5,52,53,996,1135
Maverick,15,1726,761,965,743,945,2,2,8,11,4,5,1,0,3,2,45,34,716,931
Maverick,16,1217,521,696,508,688,5,1,5,6,1,1,0,0,2,0,28,24,493,672
Maverick,17,950,414,536,409,519,1,2,4,11,0,0,0,0,0,4,14,22,400,514
Maverick,18,728,302,426,293,413,4,5,3,4,1,2,0,0,1,2,17,16,285,410
Medina,5,3456,2116,1340,1816,1259,239,21,10,32,21,7,1,1,29,20,861,480,1255,860
Medina,6,3222,1786,1436,1568,1354,174,27,9,15,8,10,4,2,23,28,707,545,1079,891
Medina,7,3053,1640,1413,1462,1316,104,25,14,19,31,28,2,7,27,18,696,592,944,821
Medina,8,2952,1508,1444,1389,1357,67,10,9,22,9,30,4,4,30,21,704,628,804,816
Medina,9,2910,1518,1392,1383,1328,63,22,18,12,27,11,3,1,24,18,712,612,806,780
Medina,10,3374,1733,1641,1578,1547,93,30,25,20,12,22,4,1,21,21,808,792,925,849
Medina,11,3332,1675,1657,1565,1572,58,41,15,17,8,14,6,0,23,13,862,843,813,814
Medina,12,3613,1851,1762,1725,1675,66,42,26,20,12,13,3,5,19,7,1051,970,800,792
Medina,13,3248,1584,1664,1509,1594,33,17,23,23,7,13,2,1,10,16,937,983,647,681
Medina,14,2775,1372,1403,1305,1350,26,10,13,15,7,14,6,1,15,13,859,827,513,576
Medina,15,2293,1138,1155,1089,1131,18,6,10,8,6,7,2,1,13,2,707,698,431,457
Medina,16,1452,683,769,660,748,7,1,5,6,1,6,2,2,8,6,459,499,224,270
Medina,17,992,439,553,424,535,1,4,8,7,3,4,1,0,2,3,309,344,130,209
Medina,18,972,370,602,355,592,3,2,2,1,2,2,2,1,6,4,263,389,107,213
Menard,5,88,50,38,45,37,1,1,2,0,0,0,0,0,2,0,19,21,31,17
Menard,6,100,55,45,49,40,4,2,2,2,0,1,0,0,0,0,30,25,25,20
Menard,7,84,48,36,46,36,1,0,0,0,1,0,0,0,0,0,29,24,19,12
Menard,8,98,42,56,39,53,0,0,2,3,0,0,0,0,1,0,21,28,21,28
Menard,9,85,33,52,30,50,2,2,0,0,0,0,0,0,1,0,23,21,10,31
Menard,10,103,41,62,40,61,1,0,0,1,0,0,0,0,0,0,21,34,20,28
Menard,11,113,59,54,56,51,2,0,0,3,0,0,0,0,1,0,33,36,26,18
Menard,12,182,80,102,76,101,0,0,1,0,1,1,0,0,2,0,51,66,29,36
Menard,13,182,90,92,83,87,6,1,1,4,0,0,0,0,0,0,65,70,25,22
Menard,14,168,82,86,78,84,2,0,2,2,0,0,0,0,0,0,58,67,24,19
Menard,15,176,101,75,101,74,0,0,0,0,0,0,0,0,0,1,74,56,27,19
Menard,16,137,69,68,68,68,0,0,0,0,0,0,0,0,1,0,55,51,14,17
Menard,17,78,35,43,35,42,0,1,0,0,0,0,0,0,0,0,25,30,10,13
Menard,18,107,54,53,53,51,0,0,0,2,0,0,0,0,1,0,45,43,9,10
Midland,5,10955,5573,5382,4932,4707,353,434,65,62,130,67,2,6,91,106,2522,2396,3051,2986
Midland,6,15699,8203,7496,7186,6658,547,458,104,90,224,174,17,11,125,105,4244,3881,3959,3615
Midland,7,15474,8212,7262,7165,6385,570,480,116,86,241,185,9,12,111,114,4306,3918,3906,3344
Midland,8,13133,6967,6166,6099,5427,468,376,81,89,230,208,11,6,78,60,3759,3278,3208,2888
Midland,9,10165,5294,4871,4653,4218,371,404,74,62,127,140,3,4,66,43,2746,2631,2548,2240
Midland,10,9115,4640,4475,4121,3966,314,291,53,63,110,115,2,4,40,36,2496,2425,2144,2050
Midland,11,8530,4219,4311,3729,3843,314,318,59,45,73,68,5,6,39,31,2378,2468,1841,1843
Midland,12,9612,4603,5009,4147,4479,291,373,69,49,56,65,8,3,32,40,3088,3474,1515,1535
Midland,13,8683,4319,4364,3957,3973,230,247,51,47,40,52,3,8,38,37,3105,3145,1214,1219
Midland,14,5926,2824,3102,2545,2765,176,202,37,36,45,70,1,0,20,29,2159,2268,665,834
Midland,15,4066,1886,2180,1708,1972,97,141,25,19,37,23,0,0,19,25,1451,1616,435,564
Midland,16,2827,1200,1627,1072,1481,83,109,13,9,19,17,4,0,9,11,941,1261,259,366
Midland,17,2310,919,1391,829,1289,59,75,6,9,12,10,0,0,13,8,735,1133,184,258
Midland,18,2660,963,1697,911,1570,29,92,9,14,6,11,1,0,7,10,796,1444,167,253
Milam,5,1371,738,633,607,539,99,65,9,10,3,2,1,0,19,17,465,389,273,244
Milam,6,1331,632,699,520,600,85,69,12,5,3,16,1,1,11,8,433,475,199,224
Milam,7,1316,671,645,579,547,51,65,11,13,16,13,1,0,13,7,441,431,230,214
Milam,8,1436,676,760,610,673,51,68,7,5,1,8,0,0,7,6,432,535,244,225
Milam,9,1331,638,693,562,571,56,70,4,9,6,39,0,0,10,4,446,499,192,194
Milam,10,1441,693,748,607,640,62,70,10,12,5,22,0,0,9,4,505,558,188,190
Milam,11,1475,702,773,621,684,61,66,13,14,3,4,1,0,3,5,560,605,142,168
Milam,12,1770,877,893,770,775,79,92,13,11,6,6,2,1,7,8,727,737,150,156
Milam,13,1753,864,889,749,788,84,80,21,10,6,1,0,0,4,10,726,768,138,121
Milam,14,1584,741,843,674,770,51,58,8,6,4,2,0,0,4,7,646,744,95,99
Milam,15,1303,661,642,607,583,44,49,3,4,3,3,0,1,4,2,581,576,80,66
Milam,16,873,429,444,401,394,21,41,3,7,2,0,0,0,2,2,400,402,29,42
Milam,17,645,275,370,242,334,27,30,2,0,2,2,0,0,2,4,244,338,31,32
Milam,18,679,244,435,222,390,14,39,3,4,1,2,0,0,4,0,228,417,16,18
Mills,5,224,111,113,105,107,4,3,1,1,0,0,0,0,1,2,77,79,34,34
Mills,6,214,120,94,110,89,4,2,3,0,1,2,0,0,2,1,81,74,39,20
Mills,7,189,91,98,89,93,2,1,0,2,0,1,0,0,0,1,66,75,25,23
Mills,8,231,103,128,101,123,0,1,1,1,0,2,0,0,1,1,83,101,20,27
Mills,9,231,111,120,105,116,3,1,1,1,2,1,0,0,0,1,76,95,35,25
Mills,10,270,124,146,117,139,2,1,2,2,0,0,0,0,3,4,98,113,26,33
Mills,11,312,165,147,158,145,0,0,2,2,3,0,0,0,2,0,130,114,35,33
Mills,12,354,166,188,163,184,3,1,0,2,0,0,0,0,0,1,135,166,31,22
Mills,13,360,178,182,173,174,1,1,2,4,1,2,0,0,1,1,155,165,23,17
Mills,14,409,197,212,193,207,0,1,0,1,1,1,1,0,2,2,184,182,13,30
Mills,15,333,166,167,162,164,0,0,2,1,0,0,0,0,2,2,160,161,6,6
Mills,16,284,153,131,150,131,2,0,0,0,0,0,0,0,1,0,139,120,14,11
Mills,17,155,68,87,67,87,0,0,0,0,0,0,0,0,1,0,62,80,6,7
Mills,18,201,83,118,82,116,0,0,0,1,0,0,0,0,1,1,73,111,10,7
Mitchell,5,800,633,167,401,151,202,8,10,3,6,1,0,0,14,4,322,90,311,77
Mitchell,6,849,652,197,454,178,177,13,8,2,2,1,1,0,10,3,335,105,317,92
Mitchell,7,664,476,188,344,172,109,5,9,4,5,3,1,1,8,3,264,103,212,85
Mitchell,8,605,397,208,295,195,80,5,6,3,7,3,2,1,7,1,213,139,184,69
Mitchell,9,519,361,158,270,147,71,8,8,1,4,1,1,0,7,1,207,93,154,65
Mitchell,10,519,304,215,242,199,42,10,10,3,4,3,0,0,6,0,171,128,133,87
Mitchell,11,488,299,189,241,174,46,6,6,3,1,1,0,0,5,5,184,124,115,65
Mitchell,12,466,239,227,213,210,16,9,7,6,0,0,0,0,3,2,175,164,64,63
Mitchell,13,420,200,220,180,209,8,6,7,1,2,1,0,0,3,3,136,154,64,66
Mitchell,14,408,202,206,192,189,5,9,5,5,0,0,0,0,0,3,142,144,60,62
Mitchell,15,306,156,150,145,139,6,4,4,1,1,5,0,0,0,1,112,113,44,37
Mitchell,16,219,100,119,89,110,6,3,3,3,0,0,0,0,2,3,81,89,19,30
Mitchell,17,153,60,93,57,90,2,1,1,2,0,0,0,0,0,0,47,69,13,24
Mitchell,18,144,48,96,44,85,3,6,1,2,0,0,0,0,0,3,46,81,2,15
Montague,5,959,463,496,425,465,12,7,6,13,4,0,0,0,16,11,405,407,58,89
Montague,6,1103,537,566,503,552,9,2,8,5,3,1,1,0,13,6,466,461,71,105
Montague,7,1081,541,540,524,520,2,5,8,6,3,2,0,1,4,6,446,469,95,71
Montague,8,1052,516,536,488,512,3,1,17,10,0,3,0,0,8,10,436,450,80,86
Montague,9,1024,508,516,483,491,5,5,8,9,2,5,0,0,10,6,453,446,55,70
Montague,10,1118,555,563,537,534,1,1,10,13,2,7,0,0,5,8,503,501,52,62
Montague,11,1245,618,627,595,596,7,4,5,10,4,5,1,1,6,11,570,577,48,50
Montague,12,1423,728,695,695,667,4,2,13,7,4,6,0,0,12,13,662,649,66,46
Montague,13,1406,677,729,654,708,6,1,12,8,0,4,0,0,5,8,638,699,39,30
Montague,14,1233,573,660,555,652,1,0,8,4,2,1,0,0,7,3,556,649,17,11
Montague,15,1227,606,621,597,605,0,0,1,6,2,1,0,0,6,9,586,604,20,17
Montague,16,796,400,396,390,391,0,0,3,1,0,0,0,0,7,4,388,393,12,3
Montague,17,572,247,325,240,318,0,0,3,5,0,0,0,0,4,2,241,322,6,3
Montague,18,498,197,301,196,294,0,0,1,5,0,1,0,0,0,1,192,295,5,6
Montgomery,5,34187,17264,16923,15148,14642,1080,1158,208,223,404,469,17,23,407,408,11459,11490,5805,5433
Montgomery,6,37190,18837,18353,16295,15724,1344,1370,243,215,601,665,42,19,312,360,13332,13185,5505,5168
Montgomery,7,37914,18779,19135,16289,16417,1316,1317,190,221,660,807,32,28,292,345,13499,14138,5280,4997
Montgomery,8,41394,20496,20898,17721,17961,1397,1399,258,220,822,990,33,28,265,300,14740,15466,5756,5432
Montgomery,9,39547,19542,20005,17093,17111,1214,1337,189,183,802,1067,19,21,225,286,14229,14716,5313,5289
Montgomery,10,41309,20441,20868,18159,18217,1037,1167,209,206,789,975,30,27,217,276,15490,16005,4951,4863
Montgomery,11,38630,19269,19361,17322,17237,915,1014,215,183,584,702,27,23,206,202,15120,15469,4149,3892
Montgomery,12,38653,19071,19582,17471,17703,810,965,162,153,442,533,20,14,166,214,16136,16708,2935,2874
Montgomery,13,34318,16853,17465,15518,15924,733,806,139,113,315,447,15,8,133,167,14719,15357,2134,2108
Montgomery,14,27175,12853,14322,11920,13147,451,620,98,79,279,350,4,11,101,115,11598,12875,1255,1447
Montgomery,15,21111,9950,11161,9277,10458,346,332,70,64,193,226,5,2,59,79,9192,10192,758,969
Montgomery,16,13805,6269,7536,5914,7053,157,208,48,34,112,184,4,5,34,52,5790,6940,479,596
Montgomery,17,7869,3366,4503,3175,4243,61,132,15,26,82,77,2,2,31,23,3126,4138,240,365
Montgomery,18,7238,2617,4621,2449,4342,79,159,21,21,46,70,2,2,20,27,2414,4282,203,339
Moore,5,1354,722,632,637,567,25,13,15,6,37,37,3,2,5,7,215,200,507,432
Moore,6,1562,833,729,676,632,54,19,14,8,74,59,2,1,13,10,334,273,499,456
Moore,7,1364,762,602,596,504,72,14,19,12,60,66,6,1,9,5,317,248,445,354
Moore,8,1454,795,659,551,582,153,14,5,20,74,38,1,0,11,5,413,269,382,390
Moore,9,1273,668,605,529,513,47,12,27,20,54,53,4,2,7,5,293,258,375,347
Moore,10,1189,641,548,540,499,57,11,7,9,29,27,2,1,6,1,285,244,356,304
Moore,11,1128,613,515,537,471,23,14,15,7,25,14,5,1,8,8,268,204,345,311
Moore,12,1132,567,565,505,516,19,10,13,11,18,21,2,0,10,7,287,291,280,274
Moore,13,1077,542,535,503,492,9,0,11,11,13,26,1,0,5,6,298,327,244,208
Moore,14,786,382,404,344,368,15,1,12,6,9,21,0,0,2,8,226,262,156,142
Moore,15,563,270,293,256,280,4,2,5,2,2,3,0,1,3,5,177,192,93,101
Moore,16,405,187,218,178,195,2,3,1,2,5,18,0,0,1,0,125,157,62,61
Moore,17,302,130,172,128,159,0,4,2,3,0,3,0,0,0,3,93,133,37,39
Moore,18,287,122,165,110,156,0,0,4,3,3,2,0,0,5,4,90,134,32,31
Morris,5,634,314,320,198,191,98,103,8,2,1,4,0,1,9,19,258,273,56,47
Morris,6,714,343,371,240,271,94,87,5,5,0,1,0,1,4,6,289,323,54,48
Morris,7,633,322,311,229,218,73,82,5,4,4,1,0,0,11,6,292,272,30,39
Morris,8,735,362,373,261,269,85,88,7,6,3,5,0,0,6,5,328,339,34,34
Morris,9,657,282,375,211,286,59,83,4,1,1,1,0,0,7,4,256,330,26,45
Morris,10,680,317,363,236,270,71,83,5,5,3,1,1,1,1,3,282,330,35,33
Morris,11,702,333,369,256,254,57,98,9,8,1,4,4,0,6,5,307,342,26,27
Morris,12,872,412,460,304,322,98,126,4,6,3,3,0,0,3,3,388,434,24,26
Morris,13,920,409,511,317,377,78,116,7,10,2,2,0,0,5,6,381,494,28,17
Morris,14,787,370,417,295,312,67,89,4,4,0,6,0,1,4,5,349,398,21,19
Morris,15,669,315,354,262,275,49,66,3,3,0,3,0,2,1,5,308,346,7,8
Morris,16,499,240,259,189,212,43,37,3,5,1,4,0,0,4,1,230,257,10,2
Morris,17,409,187,222,158,179,24,37,1,4,1,2,0,0,3,0,182,220,5,2
Morris,18,317,110,207,82,150,24,53,1,1,0,0,0,0,3,3,108,206,2,1
Motley,5,59,38,21,33,19,2,0,1,1,1,0,0,0,1,1,26,17,12,4
Motley,6,55,28,27,25,25,3,0,0,2,0,0,0,0,0,0,22,21,6,6
Motley,7,67,38,29,29,27,5,0,2,0,0,0,0,0,2,2,29,20,9,9
Motley,8,47,20,27,19,27,1,0,0,0,0,0,0,0,0,0,15,21,5,6
Motley,9,50,23,27,22,27,0,0,1,0,0,0,0,0,0,0,20,19,3,8
Motley,10,77,39,38,37,36,2,0,0,2,0,0,0,0,0,0,30,30,9,8
Motley,11,50,34,16,28,13,2,1,4,2,0,0,0,0,0,0,30,15,4,1
Motley,12,95,52,43,50,41,0,0,1,2,0,0,0,0,1,0,49,37,3,6
Motley,13,83,36,47,36,47,0,0,0,0,0,0,0,0,0,0,33,45,3,2
Motley,14,123,58,65,55,63,3,2,0,0,0,0,0,0,0,0,52,60,6,5
Motley,15,79,43,36,42,36,1,0,0,0,0,0,0,0,0,0,39,32,4,4
Motley,16,74,31,43,31,40,0,2,0,1,0,0,0,0,0,0,27,40,4,3
Motley,17,49,22,27,21,26,0,0,1,1,0,0,0,0,0,0,21,27,1,0
Motley,18,53,26,27,26,24,0,3,0,0,0,0,0,0,0,0,25,25,1,2
Nacogdoches,5,8423,3975,4448,3167,3402,656,874,29,42,36,59,1,4,86,67,3225,3687,750,761
Nacogdoches,6,4198,2117,2081,1576,1494,436,498,16,24,36,22,2,2,51,41,1646,1652,471,429
Nacogdoches,7,3385,1672,1713,1259,1281,335,364,19,12,27,38,3,0,29,18,1269,1355,403,358
Nacogdoches,8,3532,1741,1791,1394,1362,283,356,14,21,27,31,1,2,22,19,1331,1451,410,340
Nacogdoches,9,3116,1466,1650,1176,1274,242,294,14,23,18,44,0,0,16,15,1122,1277,344,373
Nacogdoches,10,3187,1532,1655,1253,1285,219,318,24,7,17,35,1,0,18,10,1227,1342,305,313
Nacogdoches,11,3329,1635,1694,1303,1308,275,327,20,23,25,16,1,2,11,18,1338,1441,297,253
Nacogdoches,12,3657,1764,1893,1447,1486,250,350,15,18,32,16,0,0,20,23,1502,1672,262,221
Nacogdoches,13,3631,1708,1923,1409,1508,258,340,8,13,19,42,0,1,14,19,1527,1774,181,149
Nacogdoches,14,3225,1565,1660,1322,1342,204,273,10,12,12,24,1,1,16,8,1442,1573,123,87
Nacogdoches,15,2506,1212,1294,1039,1083,127,186,14,6,18,8,0,0,14,11,1152,1233,60,61
Nacogdoches,16,1662,729,933,641,797,76,117,5,3,2,11,0,0,5,5,686,886,43,47
Nacogdoches,17,1108,443,665,389,570,42,74,4,4,4,5,0,1,4,11,413,636,30,29
Nacogdoches,18,1160,417,743,362,636,43,89,4,6,3,2,0,0,5,10,390,719,27,24
Navarro,5,3019,1550,1469,1264,1161,218,228,17,23,8,11,18,14,25,32,972,880,578,589
Navarro,6,2978,1452,1526,1157,1166,225,251,18,18,16,13,23,53,13,25,983,1066,469,460
Navarro,7,2775,1322,1453,1040,1117,201,238,22,21,9,14,27,36,23,27,915,1023,407,430
Navarro,8,2866,1364,1502,1146,1206,138,208,13,19,15,10,38,35,14,24,937,1021,427,481
Navarro,9,2714,1279,1435,1070,1176,148,184,19,17,8,14,20,23,14,21,875,996,404,439
Navarro,10,2977,1456,1521,1227,1231,176,209,10,20,11,18,23,22,9,21,1038,1109,418,412
Navarro,11,2957,1503,1454,1220,1157,208,241,27,20,17,13,17,15,14,8,1157,1163,346,291
Navarro,12,3302,1598,1704,1326,1406,229,243,12,18,10,16,11,9,10,12,1283,1436,315,268
Navarro,13,3077,1521,1556,1289,1267,179,235,19,20,8,14,5,4,21,16,1305,1357,216,199
Navarro,14,2742,1320,1422,1100,1207,176,176,14,15,9,11,6,1,15,12,1205,1277,115,145
Navarro,15,2193,1063,1130,928,974,112,138,8,7,3,3,0,2,12,6,987,1042,76,88
Navarro,16,1579,709,870,642,775,48,82,9,4,3,2,3,1,4,6,654,814,55,56
Navarro,17,976,429,547,388,485,35,53,2,3,2,1,0,1,2,4,391,509,38,38
Navarro,18,991,340,651,301,526,30,103,4,9,2,7,2,1,1,5,310,619,30,32
Newton,5,835,497,338,344,244,137,81,5,2,4,0,0,0,7,11,457,315,40,23
Newton,6,893,508,385,332,310,147,67,2,2,23,3,0,0,4,3,480,370,28,15
Newton,7,747,424,323,325,255,92,58,2,4,3,1,0,0,2,5,407,306,17,17
Newton,8,789,429,360,319,283,95,71,0,3,5,2,1,0,9,1,408,346,21,14
Newton,9,710,349,361,269,293,74,59,1,2,1,1,0,0,4,6,332,345,17,16
Newton,10,853,462,391,337,298,118,79,2,3,2,1,0,0,3,10,447,377,15,14
Newton,11,957,490,467,371,364,107,91,6,3,4,3,0,0,2,6,477,458,13,9
Newton,12,1025,502,523,405,396,87,109,4,10,1,0,0,0,5,8,490,514,12,9
Newton,13,1016,498,518,411,403,79,109,3,4,2,0,0,0,3,2,492,508,6,10
Newton,14,886,423,463,341,364,73,88,2,6,2,2,1,0,4,3,417,458,6,5
Newton,15,731,346,385,281,315,62,60,0,3,0,1,0,0,3,6,340,380,6,5
Newton,16,559,275,284,231,238,38,44,5,1,0,0,0,0,1,1,269,280,6,4
Newton,17,363,170,193,145,155,21,35,1,0,0,1,0,0,3,2,169,192,1,1
Newton,18,309,127,182,102,143,23,34,1,2,0,0,0,0,1,3,127,180,0,2
Nolan,5,895,513,382,462,342,33,23,7,2,4,5,0,0,7,10,285,203,228,179
Nolan,6,837,447,390,383,346,34,27,8,6,3,6,0,0,19,5,272,223,175,167
Nolan,7,873,434,439,406,404,9,19,5,10,9,2,0,0,5,4,232,252,202,187
Nolan,8,883,439,444,399,418,20,15,8,2,3,3,2,1,7,5,270,245,169,199
Nolan,9,816,407,409,360,374,23,18,8,2,9,9,1,0,6,6,226,229,181,180
Nolan,10,847,426,421,402,393,14,18,5,7,4,2,0,0,1,1,264,244,162,177
Nolan,11,834,413,421,379,383,13,21,8,8,6,6,0,0,7,3,270,281,143,140
Nolan,12,910,432,478,389,444,31,26,7,3,3,3,0,1,2,1,326,350,106,128
Nolan,13,918,449,469,419,436,19,19,5,8,1,3,1,1,4,2,309,341,140,128
Nolan,14,829,398,431,371,399,18,18,3,5,2,2,1,0,3,7,298,287,100,144
Nolan,15,674,336,338,318,324,13,12,1,1,0,0,0,0,4,1,260,258,76,80
Nolan,16,519,242,277,234,268,4,4,1,3,0,0,0,0,3,2,186,200,56,77
Nolan,17,337,139,198,132,185,4,10,2,1,0,2,0,0,1,0,109,163,30,35
Nolan,18,347,121,226,114,212,2,6,0,2,2,2,0,0,3,4,85,203,36,23
Nueces,5,25831,13026,12805,11650,11439,656,699,132,125,313,270,21,19,254,253,3997,3936,9029,8869
Nueces,6,26866,13951,12915,12604,11684,733,600,121,113,303,292,18,11,172,215,4858,4361,9093,8554
Nueces,7,25096,12722,12374,11504,11218,638,515,106,114,285,340,25,28,164,159,4521,4269,8201,8105
Nueces,8,24800,12510,12290,11313,11170,602,493,127,96,243,334,33,21,192,176,4358,4042,8152,8248
Nueces,9,21648,10634,11014,9657,10052,417,384,109,102,296,339,19,19,136,118,3575,3509,7059,7505
Nueces,10,21483,10549,10934,9607,9939,428,380,111,80,287,401,16,13,100,121,3843,3800,6706,7134
Nueces,11,20721,10142,10579,9282,9685,426,392,97,120,206,280,21,19,110,83,4027,4074,6115,6505
Nueces,12,22655,10991,11664,10098,10785,453,431,126,107,217,239,14,15,83,87,4880,4912,6111,6752
Nueces,13,21524,10367,11157,9479,10274,456,429,120,95,221,254,6,5,85,100,5097,5078,5270,6079
Nueces,14,17184,8208,8976,7637,8298,298,321,76,71,129,217,13,7,55,62,4093,4117,4115,4859
Nueces,15,13630,6423,7207,5999,6688,200,224,58,57,122,179,6,3,38,56,3219,3311,3204,3896
Nueces,16,8864,3919,4945,3663,4626,140,157,27,32,66,87,2,6,21,37,2094,2359,1825,2586
Nueces,17,6218,2488,3730,2343,3487,71,138,19,24,37,50,2,2,16,29,1239,1744,1249,1986
Nueces,18,6352,2179,4173,2060,3911,46,147,27,26,23,75,1,3,22,11,1155,2187,1024,1986
Ochiltree,5,640,338,302,321,283,1,2,9,7,1,3,0,0,6,7,115,116,223,186
Ochiltree,6,642,327,315,300,297,9,3,6,7,5,1,1,0,6,7,117,132,210,183
Ochiltree,7,639,323,316,309,300,2,4,4,4,3,2,1,0,4,6,120,143,203,173
Ochiltree,8,593,293,300,275,277,7,6,2,9,3,3,0,0,6,5,126,130,167,170
Ochiltree,9,640,338,302,326,298,4,1,4,1,1,1,0,0,3,1,121,125,217,177
Ochiltree,10,554,289,265,274,252,5,6,7,5,2,1,0,1,1,0,121,109,168,156
Ochiltree,11,546,281,265,268,249,4,0,4,5,2,3,0,0,3,8,133,154,148,111
Ochiltree,12,588,299,289,281,281,4,1,7,2,3,2,0,1,4,2,192,177,107,112
Ochiltree,13,544,275,269,266,256,0,2,4,7,2,1,1,0,2,3,186,190,89,79
Ochiltree,14,372,185,187,181,185,0,0,4,1,0,1,0,0,0,0,137,150,48,37
Ochiltree,15,305,158,147,156,144,0,0,2,1,0,0,0,0,0,2,120,117,38,30
Ochiltree,16,217,86,131,84,127,0,0,2,2,0,0,0,0,0,2,73,114,13,17
Ochiltree,17,114,53,61,53,56,0,0,0,4,0,0,0,1,0,0,42,48,11,13
Ochiltree,18,116,51,65,50,60,0,0,1,4,0,0,0,0,0,1,47,51,4,14
Oldham,5,109,60,49,52,44,4,2,1,1,2,1,0,0,1,1,50,39,10,10
Oldham,6,119,48,71,46,63,0,4,0,0,2,1,0,1,0,2,41,56,7,15
Oldham,7,123,59,64,55,61,3,1,1,0,0,2,0,0,0,0,46,54,13,10
Oldham,8,182,95,87,92,81,0,2,0,0,0,3,0,0,3,1,72,75,23,12
Oldham,9,117,53,64,50,63,2,0,0,0,0,1,0,0,1,0,45,51,8,13
Oldham,10,152,75,77,72,70,0,3,1,1,0,2,0,0,2,1,68,65,7,12
Oldham,11,133,59,74,55,71,0,0,2,0,1,1,0,0,1,2,47,65,12,9
Oldham,12,162,94,68,91,64,0,0,1,2,1,2,0,0,1,0,81,56,13,12
Oldham,13,144,71,73,70,68,0,1,0,1,1,2,0,0,0,1,62,68,9,5
Oldham,14,103,55,48,52,45,2,1,1,1,0,1,0,0,0,0,51,43,4,5
Oldham,15,89,46,43,44,41,0,0,2,0,0,1,0,0,0,1,40,38,6,5
Oldham,16,53,18,35,14,35,0,0,0,0,1,0,0,0,3,0,16,33,2,2
Oldham,17,36,19,17,18,17,0,0,1,0,0,0,0,0,0,0,18,13,1,4
Oldham,18,31,14,17,13,17,0,0,0,0,1,0,0,0,0,0,13,14,1,3
Orange,5,4874,2470,2404,2078,2001,286,278,17,28,36,59,6,2,47,36,2209,2150,261,254
Orange,6,5663,2932,2731,2524,2365,294,276,30,20,33,20,3,3,48,47,2651,2481,281,250
Orange,7,5379,2638,2741,2362,2396,204,251,20,23,22,47,3,2,27,22,2331,2505,307,236
Orange,8,5275,2620,2655,2348,2359,192,204,23,18,29,38,2,6,26,30,2359,2436,261,219
Orange,9,4896,2427,2469,2154,2165,186,225,20,12,40,37,3,4,24,26,2183,2276,244,193
Orange,10,5191,2602,2589,2339,2259,172,237,31,18,35,40,3,3,22,32,2406,2421,196,168
Orange,11,5213,2572,2641,2297,2341,193,230,18,13,32,30,4,1,28,26,2428,2498,144,143
Orange,12,5737,2849,2888,2563,2591,209,209,29,22,26,38,2,1,20,27,2727,2767,122,121
Orange,13,5396,2616,2780,2352,2469,189,229,20,22,31,32,2,2,22,26,2508,2696,108,84
Orange,14,4327,2078,2249,1881,2050,140,149,18,12,18,16,1,1,20,21,1996,2174,82,75
Orange,15,3385,1579,1806,1431,1622,117,141,8,10,7,15,1,1,15,17,1529,1755,50,51
Orange,16,2484,1143,1341,1049,1227,71,83,5,8,7,8,0,0,11,15,1114,1296,29,45
Orange,17,1672,686,986,620,892,41,70,9,8,5,6,0,0,11,10,661,953,25,33
Orange,18,1509,572,937,506,839,42,75,6,3,6,7,0,0,12,13,536,897,36,40
Palo,5,1736,897,839,816,792,29,9,12,9,17,4,2,3,21,22,618,595,279,244
Palo,6,1826,911,915,834,857,28,16,12,13,29,15,3,1,5,13,703,695,208,220
Palo,7,1619,836,783,770,739,27,15,7,10,13,8,1,1,18,10,613,601,223,182
Palo,8,1503,679,824,639,778,18,22,6,10,8,6,0,0,8,8,512,658,167,166
Palo,9,1511,728,783,675,728,27,23,11,10,4,11,0,0,11,11,576,619,152,164
Palo,10,1683,814,869,774,825,22,17,6,6,4,7,2,1,6,13,621,686,193,183
Palo,11,1768,829,939,782,895,30,11,8,17,3,4,0,0,6,12,701,782,128,157
Palo,12,2086,1017,1069,966,1013,28,29,11,8,5,8,0,0,7,11,858,942,159,127
Palo,13,2075,991,1084,945,1015,22,37,10,11,7,6,1,1,6,14,881,1010,110,74
Palo,14,1763,853,910,811,860,21,17,8,12,3,8,0,3,10,10,771,823,82,87
Palo,15,1604,807,797,778,763,15,13,5,10,4,6,1,2,4,3,761,744,46,53
Palo,16,1070,505,565,487,550,6,4,8,1,2,4,0,0,2,6,476,540,29,25
Palo,17,642,285,357,277,338,2,8,2,2,4,6,0,0,0,3,266,341,19,16
Palo,18,619,234,385,219,370,5,7,3,2,3,5,0,0,4,1,220,368,14,17
Panola,5,1331,708,623,547,475,134,122,3,8,10,5,0,1,14,12,628,536,80,87
Panola,6,1327,697,630,542,506,127,103,5,3,5,5,0,0,18,13,611,573,86,57
Panola,7,1278,667,611,539,482,99,110,9,6,1,0,1,1,18,12,579,543,88,68
Panola,8,1423,697,726,574,587,107,116,2,3,5,5,2,1,7,14,623,662,74,64
Panola,9,1340,639,701,539,574,78,110,4,6,4,1,0,0,14,10,578,635,61,66
Panola,10,1328,651,677,535,549,92,110,7,4,5,8,0,0,12,6,574,622,77,55
Panola,11,1356,638,718,514,566,106,127,4,5,2,10,1,1,11,9,580,680,58,38
Panola,12,1600,775,825,648,627,106,177,4,6,5,5,0,1,12,9,731,794,44,31
Panola,13,1694,817,877,676,729,121,135,3,6,3,1,0,0,14,6,795,858,22,19
Panola,14,1493,737,756,615,631,105,107,4,9,0,1,0,0,13,8,713,740,24,16
Panola,15,1118,553,565,464,465,77,86,5,2,2,6,0,0,5,6,540,550,13,15
Panola,16,825,350,475,291,413,51,58,1,1,1,1,0,0,6,2,335,471,15,4
Panola,17,560,234,326,204,267,25,55,0,1,0,1,0,0,5,2,232,323,2,3
Panola,18,449,176,273,152,225,22,45,0,1,0,1,0,0,2,1,173,271,3,2
Parker,5,7422,3870,3552,3593,3314,106,72,52,38,33,37,2,0,84,91,3108,2903,762,649
Parker,6,7747,3872,3875,3604,3650,102,60,52,42,26,25,2,1,86,97,3257,3299,615,576
Parker,7,8496,4124,4372,3876,4187,93,43,59,39,27,41,3,2,66,60,3469,3776,655,596
Parker,8,9127,4552,4575,4299,4340,90,63,49,46,32,53,4,4,78,69,3863,3960,689,615
Parker,9,8355,4143,4212,3952,4029,76,49,40,43,28,44,1,1,46,46,3558,3686,585,526
Parker,10,9324,4509,4815,4315,4576,78,80,39,39,25,50,9,2,43,68,3935,4195,574,620
Parker,11,9612,4825,4787,4587,4571,91,52,49,60,27,46,8,1,63,57,4345,4313,480,474
Parker,12,10235,5161,5074,4969,4870,64,47,53,51,32,48,3,5,40,53,4728,4710,433,364
Parker,13,9007,4377,4630,4163,4450,84,85,48,36,21,23,3,0,58,36,4121,4390,256,240
Parker,14,7323,3525,3798,3388,3671,37,43,38,25,19,27,5,2,38,30,3310,3625,215,173
Parker,15,5747,2816,2931,2746,2840,15,22,18,24,5,13,2,3,30,29,2700,2837,116,94
Parker,16,3824,1854,1970,1799,1915,9,12,14,16,7,11,0,1,25,15,1789,1891,65,79
Parker,17,2326,1030,1296,1003,1254,9,8,11,15,1,8,0,2,6,9,994,1241,36,55
Parker,18,2055,809,1246,786,1209,7,12,11,11,5,5,0,0,0,9,771,1217,38,29
Parmer,5,624,346,278,328,259,4,3,9,3,2,7,0,2,3,4,95,79,251,199
Parmer,6,637,370,267,340,246,7,5,10,4,1,9,1,0,11,3,114,85,256,182
Parmer,7,605,310,295,279,273,12,3,5,6,1,8,4,1,9,4,81,91,229,204
Parmer,8,629,337,292,312,274,6,4,10,8,1,3,4,1,4,2,114,93,223,199
Parmer,9,537,296,241,274,219,5,3,5,11,3,4,2,2,7,2,93,62,203,179
Parmer,10,537,259,278,232,267,5,2,7,4,5,2,4,0,6,3,77,97,182,181
Parmer,11,600,300,300,280,291,2,4,9,4,5,1,1,0,3,0,108,119,192,181
Parmer,12,615,304,311,289,296,5,4,7,4,1,2,0,1,2,4,134,146,170,165
Parmer,13,552,298,254,284,248,6,4,4,1,2,1,0,0,2,0,141,123,157,131
Parmer,14,407,200,207,193,198,5,2,0,4,1,1,0,0,1,2,112,121,88,86
Parmer,15,319,159,160,155,149,1,4,2,4,1,2,0,0,0,1,93,98,66,62
Parmer,16,257,115,142,108,139,4,2,2,0,0,0,0,0,1,1,83,108,32,34
Parmer,17,185,81,104,79,98,1,3,0,2,0,0,0,0,1,1,56,73,25,31
Parmer,18,162,62,100,57,98,1,2,2,0,0,0,0,0,2,0,42,82,20,18
Pecos,5,942,562,380,479,351,53,8,12,2,3,7,3,0,12,12,183,76,379,304
Pecos,6,1191,744,447,640,420,79,5,6,6,15,10,0,1,4,5,271,104,473,343
Pecos,7,1272,789,483,691,453,75,8,7,10,11,6,0,2,5,4,313,111,476,372
Pecos,8,1245,793,452,691,432,82,8,11,5,5,3,0,0,4,4,295,107,498,345
Pecos,9,1053,690,363,593,341,80,4,8,6,5,7,0,0,4,5,282,82,408,281
Pecos,10,985,632,353,543,335,77,4,2,5,5,5,0,1,5,3,292,88,340,265
Pecos,11,1000,585,415,521,384,44,7,7,6,8,8,0,1,5,9,255,134,330,281
Pecos,12,893,494,399,439,372,38,5,8,6,4,13,0,0,5,3,213,172,281,227
Pecos,13,784,427,357,402,350,13,1,4,2,5,4,0,0,3,0,181,115,246,242
Pecos,14,668,327,341,298,326,11,4,11,4,4,4,0,0,3,3,136,123,191,218
Pecos,15,525,273,252,261,245,4,2,5,3,3,1,0,0,0,1,94,98,179,154
Pecos,16,390,171,219,163,211,0,0,2,3,3,1,1,1,2,3,51,76,120,143
Pecos,17,268,146,122,139,121,0,1,3,0,2,0,0,0,2,0,58,48,88,74
Pecos,18,229,99,130,95,118,1,0,0,7,2,3,0,1,1,1,36,56,63,74
Polk,5,2791,1676,1115,1336,900,262,122,41,51,10,10,2,1,25,31,1086,895,590,220
Polk,6,3053,1822,1231,1427,1050,317,116,46,31,12,21,1,1,19,12,1316,1018,506,213
Polk,7,3028,1800,1228,1401,1067,324,94,42,34,15,16,1,0,17,17,1292,1009,508,219
Polk,8,3084,1848,1236,1396,1043,375,125,36,30,17,25,0,4,24,9,1433,1033,415,203
Polk,9,2805,1636,1169,1262,993,317,119,30,31,9,15,1,1,17,10,1320,1002,316,167
Polk,10,3060,1744,1316,1386,1144,300,109,33,37,12,14,1,0,12,12,1442,1134,302,182
Polk,11,3292,1746,1546,1472,1347,218,127,33,40,8,12,1,2,14,18,1488,1371,258,175
Polk,12,3953,1894,2059,1639,1834,175,143,38,43,13,14,4,2,25,23,1657,1880,237,179
Polk,13,4512,2252,2260,2000,2032,170,148,37,29,15,27,2,2,28,22,2086,2131,166,129
Polk,14,3865,1973,1892,1813,1723,104,110,31,33,5,13,1,0,19,13,1874,1803,99,89
Polk,15,2672,1419,1253,1335,1164,54,50,15,16,7,11,0,0,8,12,1365,1211,54,42
Polk,16,1504,793,711,734,654,29,29,20,16,5,3,0,0,5,9,765,688,28,23
Polk,17,721,349,372,313,339,22,26,8,4,0,1,0,0,6,2,334,358,15,14
Polk,18,554,218,336,196,296,8,26,7,5,0,0,0,0,7,9,199,323,19,13
Potter,5,7896,4146,3750,3138,2979,614,400,69,70,228,189,14,9,83,103,2129,1847,2017,1903
Potter,6,9178,4821,4357,3614,3448,723,480,56,55,355,281,8,6,65,87,2738,2450,2083,1907
Potter,7,8767,4785,3982,3587,3128,715,430,63,54,347,305,5,8,68,57,2810,2358,1975,1624
Potter,8,8258,4540,3718,3461,3066,696,330,52,54,260,221,7,8,64,39,2807,2174,1733,1544
Potter,9,7192,3898,3294,2991,2715,566,264,50,46,254,228,3,1,34,40,2509,1992,1389,1302
Potter,10,7105,3910,3195,3066,2657,533,270,55,43,218,180,5,2,33,43,2537,2018,1373,1177
Potter,11,6747,3636,3111,2902,2594,468,280,75,54,164,137,2,5,25,41,2384,2027,1252,1084
Potter,12,6871,3462,3409,2897,2885,334,311,61,51,137,115,1,1,32,46,2488,2469,974,940
Potter,13,6370,3167,3203,2682,2749,292,266,46,36,116,113,1,5,30,34,2380,2433,787,770
Potter,14,4927,2423,2504,2081,2134,171,214,46,33,105,101,1,1,19,21,1880,2010,543,494
Potter,15,3620,1642,1978,1419,1726,113,132,22,21,75,71,0,0,13,28,1333,1581,309,397
Potter,16,2529,1117,1412,999,1256,58,93,15,15,34,31,0,1,11,16,938,1177,179,235
Potter,17,1807,741,1066,653,953,48,62,9,17,22,23,0,0,9,11,623,901,118,165
Potter,18,1995,695,1300,630,1193,39,64,8,12,17,16,1,1,0,14,583,1133,112,167
Presidio,5,382,185,197,171,182,3,6,4,5,4,3,0,0,3,1,21,20,164,177
Presidio,6,340,179,161,167,150,7,1,2,6,2,3,0,0,1,1,27,25,152,136
Presidio,7,356,184,172,177,165,4,1,1,2,1,3,0,0,1,1,31,37,153,135
Presidio,8,394,220,174,185,161,6,2,1,5,23,4,0,0,5,2,55,33,165,141
Presidio,9,364,162,202,141,179,2,1,5,4,10,15,0,0,4,3,35,41,127,161
Presidio,10,355,167,188,151,174,3,3,7,2,3,6,0,0,3,3,43,33,124,155
Presidio,11,354,167,187,162,180,0,1,3,3,1,2,0,0,1,1,21,22,146,165
Presidio,12,337,162,175,151,167,4,1,4,1,2,3,0,0,1,3,25,30,137,145
Presidio,13,358,181,177,172,171,3,0,3,3,1,1,0,0,2,2,42,36,139,141
Presidio,14,386,200,186,188,181,1,3,5,0,1,0,0,0,5,2,49,43,151,143
Presidio,15,381,208,173,199,166,2,0,5,4,0,1,0,0,2,2,54,34,154,139
Presidio,16,323,147,176,145,170,1,1,1,3,0,0,0,0,0,2,25,32,122,144
Presidio,17,242,138,104,135,103,1,0,1,1,1,0,0,0,0,0,22,15,116,89
Presidio,18,273,123,150,118,149,1,0,3,1,0,0,0,0,1,0,17,27,106,123
Rains,5,558,293,265,259,241,9,10,7,3,5,5,1,1,12,5,252,219,41,46
Rains,6,616,294,322,270,300,7,12,8,5,0,2,0,0,9,3,249,288,45,34
Rains,7,649,314,335,300,317,8,8,1,1,3,6,0,0,2,3,263,290,51,45
Rains,8,649,323,326,305,302,5,7,3,3,3,7,0,0,7,7,268,294,55,32
Rains,9,596,295,301,280,279,10,10,2,7,1,4,0,0,2,1,271,264,24,37
Rains,10,704,342,362,320,342,8,12,9,4,0,2,0,0,5,2,304,333,38,29
Rains,11,745,378,367,359,348,11,5,2,2,3,5,0,0,3,7,350,347,28,20
Rains,12,993,501,492,474,464,9,7,5,8,5,8,1,0,7,5,476,468,25,24
Rains,13,1007,464,543,436,507,5,22,9,6,6,4,0,1,8,3,451,522,13,21
Rains,14,990,491,499,463,474,19,9,5,9,0,3,0,0,4,4,476,484,15,15
Rains,15,835,415,420,395,402,12,10,2,2,1,2,1,0,4,4,408,411,7,9
Rains,16,550,279,271,268,261,4,6,1,0,2,1,0,0,4,3,272,258,7,13
Rains,17,357,152,205,144,197,6,6,0,0,0,0,0,0,2,2,148,185,4,20
Rains,18,243,117,126,113,115,2,3,1,5,0,1,0,0,1,2,113,121,4,5
Randall,5,9111,4549,4562,4036,4041,259,204,38,65,86,115,4,2,126,135,3169,3180,1380,1382
Randall,6,9916,4988,4928,4415,4431,303,203,56,58,103,117,4,5,107,114,3467,3565,1521,1363
Randall,7,9995,5023,4972,4522,4570,245,170,55,57,102,106,7,2,92,67,3517,3531,1506,1441
Randall,8,9770,4954,4816,4452,4407,258,149,73,46,96,133,7,8,68,73,3597,3626,1357,1190
Randall,9,8165,4132,4033,3787,3773,168,104,46,36,76,75,3,7,52,38,3101,3066,1031,967
Randall,10,7792,3837,3955,3515,3686,142,108,39,31,76,80,2,4,63,46,3015,3184,822,771
Randall,11,7484,3604,3880,3325,3639,139,94,34,37,62,71,1,1,43,38,2971,3172,633,708
Randall,12,8318,3998,4320,3716,4079,135,101,55,37,54,62,2,1,36,40,3496,3720,502,600
Randall,13,8075,3835,4240,3651,4050,74,65,30,33,41,55,3,3,36,34,3436,3789,399,451
Randall,14,6901,3249,3652,3139,3496,33,48,29,32,20,35,1,2,27,39,2962,3330,287,322
Randall,15,5120,2370,2750,2281,2665,22,29,20,22,18,21,0,2,29,11,2218,2570,152,180
Randall,16,3699,1595,2104,1547,2046,7,11,13,19,15,16,2,0,11,12,1519,1970,76,134
Randall,17,2569,1065,1504,1035,1457,5,9,5,12,17,14,1,1,2,11,1011,1439,54,65
Randall,18,2273,847,1426,822,1376,11,9,3,6,6,15,1,0,4,20,821,1375,26,51
Reagan,5,269,132,137,112,125,7,3,4,1,0,2,0,0,9,6,29,31,103,106
Reagan,6,222,137,85,127,82,4,1,1,0,3,2,0,0,2,0,41,27,96,58
Reagan,7,246,138,108,126,101,9,1,2,1,0,1,0,0,1,4,33,39,105,69
Reagan,8,274,154,120,138,114,12,5,2,0,1,0,0,0,1,1,42,30,112,90
Reagan,9,272,165,107,158,102,3,1,0,1,1,0,0,0,3,3,20,26,145,81
Reagan,10,221,116,105,101,91,4,1,2,1,0,1,0,0,9,11,27,23,89,82
Reagan,11,217,112,105,105,103,4,0,3,0,0,2,0,0,0,0,44,42,68,63
Reagan,12,211,111,100,101,96,6,4,0,0,3,0,0,0,1,0,43,52,68,48
Reagan,13,212,102,110,94,103,5,4,3,2,0,0,0,0,0,1,50,64,52,46
Reagan,14,140,70,70,68,66,1,3,1,1,0,0,0,0,0,0,36,32,34,38
Reagan,15,98,56,42,51,36,1,2,3,3,1,1,0,0,0,0,22,18,34,24
Reagan,16,66,31,35,29,31,1,1,0,2,0,0,0,0,1,1,18,21,13,14
Reagan,17,62,36,26,29,24,3,2,3,0,0,0,0,0,1,0,25,19,11,7
Reagan,18,46,15,31,13,28,1,1,0,0,0,0,0,0,1,2,7,26,8,5
Real,5,157,72,85,66,76,1,5,4,1,1,0,0,0,0,3,47,51,25,34
Real,6,156,74,82,60,73,4,2,3,1,2,0,3,3,2,3,37,55,37,27
Real,7,141,69,72,64,70,1,0,1,2,2,0,0,0,1,0,41,50,28,22
Real,8,164,80,84,79,75,1,2,0,3,0,1,0,1,0,2,43,54,37,30
Real,9,157,77,80,70,75,4,0,2,2,1,1,0,0,0,2,45,51,32,29
Real,10,201,90,111,86,108,0,0,1,2,0,0,0,0,3,1,55,82,35,29
Real,11,216,111,105,104,100,2,1,1,1,0,0,1,0,3,3,78,80,33,25
Real,12,262,122,140,113,137,4,0,2,2,0,0,0,0,3,1,93,114,29,26
Real,13,349,179,170,171,165,1,0,4,2,0,1,0,0,3,2,148,145,31,25
Real,14,317,149,168,146,164,1,0,0,4,1,0,0,0,1,0,122,138,27,30
Real,15,277,133,144,126,143,0,0,2,0,0,0,1,1,4,0,103,115,30,29
Real,16,199,96,103,94,99,0,0,0,0,0,0,0,1,2,3,83,84,13,19
Real,17,149,83,66,75,63,2,0,2,1,0,0,1,0,3,2,66,60,17,6
Real,18,91,33,58,31,58,0,0,0,0,0,0,0,0,2,0,32,54,1,4
Red,5,604,304,300,233,220,52,65,9,7,2,2,0,0,8,6,264,270,40,30
Red,6,647,320,327,242,257,69,57,5,6,0,0,0,0,4,7,292,288,28,39
Red,7,593,298,295,236,227,38,54,9,7,1,1,0,0,14,6,262,269,36,26
Red,8,644,313,331,259,274,43,49,4,1,2,2,0,0,5,5,286,298,27,33
Red,9,616,300,316,245,264,41,40,5,10,3,2,0,0,6,0,285,290,15,26
Red,10,734,350,384,281,294,58,77,1,7,2,2,0,0,8,4,328,361,22,23
Red,11,795,380,415,283,301,69,97,16,10,5,0,0,0,7,7,348,399,32,16
Red,12,943,449,494,369,376,67,104,3,6,4,2,0,1,6,5,419,471,30,23
Red,13,918,447,471,360,373,79,84,5,10,0,2,0,0,3,2,435,460,12,11
Red,14,849,410,439,337,356,62,77,6,4,1,2,0,0,4,0,398,429,12,10
Red,15,769,351,418,291,361,53,49,4,1,1,1,0,0,2,6,341,414,10,4
Red,16,593,282,311,245,262,33,40,0,2,0,0,0,0,4,7,276,303,6,8
Red,17,392,186,206,156,183,25,18,2,0,0,0,0,0,3,5,181,202,5,4
Red,18,389,143,246,126,205,12,36,2,2,1,0,0,0,2,3,139,240,4,6
Reeves,5,1465,1064,401,910,375,129,9,2,4,15,4,1,1,7,8,384,71,680,330
Reeves,6,1334,946,388,851,353,70,17,7,5,13,5,0,2,5,6,262,75,684,313
Reeves,7,1341,971,370,823,330,114,9,7,3,21,23,0,1,6,4,345,78,626,292
Reeves,8,1356,992,364,868,350,91,8,7,4,20,2,0,0,6,0,334,63,658,301
Reeves,9,1059,724,335,656,316,61,4,2,10,1,3,0,0,4,2,217,63,507,272
Reeves,10,1051,713,338,639,314,66,5,0,10,5,5,0,0,3,4,252,51,461,287
Reeves,11,818,467,351,419,328,39,9,4,4,4,6,0,1,1,3,159,84,308,267
Reeves,12,721,404,317,379,303,14,5,4,3,4,3,1,1,2,2,90,88,314,229
Reeves,13,634,303,331,289,311,3,9,4,4,6,4,0,0,1,3,92,89,211,242
Reeves,14,560,315,245,287,226,10,7,6,3,7,8,1,1,4,0,87,57,228,188
Reeves,15,436,183,253,174,236,3,3,1,5,5,4,0,0,0,5,48,65,135,188
Reeves,16,374,166,208,164,196,2,6,0,2,0,4,0,0,0,0,38,56,128,152
Reeves,17,256,113,143,106,136,1,6,3,1,2,0,0,0,1,0,24,34,89,109
Reeves,18,247,84,163,78,150,5,9,0,1,1,0,0,0,0,3,31,52,53,111
Refugio,5,349,197,152,167,135,19,10,4,0,2,3,0,0,5,4,92,73,105,79
Refugio,6,413,209,204,186,184,14,14,1,1,0,3,0,0,8,2,83,90,126,114
Refugio,7,345,180,165,160,149,13,7,1,5,1,0,0,1,5,3,76,56,104,109
Refugio,8,423,213,210,186,198,17,9,1,2,4,1,0,0,5,0,90,84,123,126
Refugio,9,324,156,168,142,149,11,15,0,1,2,2,0,0,1,1,60,73,96,95
Refugio,10,398,200,198,181,186,14,5,1,1,3,4,0,0,1,2,102,93,98,105
Refugio,11,442,198,244,178,231,9,7,1,2,5,1,0,0,5,3,106,123,92,121
Refugio,12,501,262,239,227,217,20,16,2,4,6,0,0,0,7,2,153,134,109,105
Refugio,13,468,234,234,213,215,13,11,5,4,1,1,0,0,2,3,142,144,92,90
Refugio,14,419,221,198,196,185,18,9,4,2,2,2,0,0,1,0,133,132,88,66
Refugio,15,460,206,254,179,219,16,22,7,4,3,4,0,0,1,5,129,155,77,99
Refugio,16,283,128,155,118,144,9,8,1,1,0,1,0,0,0,1,85,104,43,51
Refugio,17,228,113,115,106,104,4,7,2,3,0,1,0,0,1,0,76,79,37,36
Refugio,18,177,59,118,52,111,3,7,4,0,0,0,0,0,0,0,37,76,22,42
Roberts,5,29,14,15,14,13,0,0,0,0,0,0,0,0,0,2,14,14,0,1
Roberts,6,48,21,27,19,27,0,0,0,0,0,0,0,0,2,0,17,25,4,2
Roberts,7,50,25,25,24,20,0,1,0,1,0,1,0,0,1,2,20,21,5,4
Roberts,8,74,41,33,40,33,0,0,0,0,0,0,0,0,1,0,33,32,8,1
Roberts,9,45,25,20,25,18,0,1,0,0,0,0,0,0,0,1,22,16,3,4
Roberts,10,47,18,29,18,29,0,0,0,0,0,0,0,0,0,0,14,24,4,5
Roberts,11,47,22,25,22,25,0,0,0,0,0,0,0,0,0,0,20,23,2,2
Roberts,12,70,43,27,41,26,0,0,1,1,0,0,0,0,1,0,38,24,5,3
Roberts,13,58,30,28,30,27,0,0,0,0,0,0,0,0,0,1,28,27,2,1
Roberts,14,56,26,30,23,29,0,0,0,0,0,0,0,0,3,1,25,29,1,1
Roberts,15,58,34,24,33,24,0,0,0,0,0,0,0,0,1,0,32,24,2,0
Roberts,16,35,15,20,15,19,0,0,0,1,0,0,0,0,0,0,13,20,2,0
Roberts,17,24,14,10,14,10,0,0,0,0,0,0,0,0,0,0,14,10,0,0
Roberts,18,14,4,10,4,9,0,0,0,0,0,1,0,0,0,0,4,10,0,0
Robertson,5,897,454,443,309,306,121,113,10,13,6,2,0,0,8,9,324,296,130,147
Robertson,6,1102,507,595,355,410,138,166,7,7,0,5,1,0,6,7,384,458,123,137
Robertson,7,979,499,480,384,364,97,103,6,6,6,3,0,1,6,3,374,347,125,133
Robertson,8,1062,526,536,416,408,82,101,7,6,16,10,0,0,5,11,408,392,118,144
Robertson,9,962,444,518,329,337,96,163,3,1,10,6,0,1,6,10,325,416,119,102
Robertson,10,963,461,502,380,368,62,121,3,4,8,6,0,0,8,3,352,416,109,86
Robertson,11,1122,565,557,428,426,118,112,9,6,7,7,1,1,2,5,465,465,100,92
Robertson,12,1118,544,574,441,438,83,116,11,7,2,6,0,0,7,7,466,506,78,68
Robertson,13,1192,588,604,489,462,90,122,0,6,4,6,0,0,5,8,510,530,78,74
Robertson,14,1050,507,543,423,444,75,89,4,4,2,0,0,0,3,6,438,505,69,38
Robertson,15,847,424,423,354,336,54,79,3,4,0,2,2,1,11,1,393,373,31,50
Robertson,16,593,260,333,222,275,35,53,2,2,0,0,0,0,1,3,240,307,20,26
Robertson,17,400,176,224,150,190,23,34,1,0,0,0,0,0,2,0,159,211,17,13
Robertson,18,426,159,267,138,215,18,48,1,1,0,0,0,0,2,3,150,248,9,19
Rockwall,5,5511,2899,2612,2460,2225,242,205,30,30,88,68,6,3,73,81,2133,1983,766,629
Rockwall,6,5008,2506,2502,2137,2158,207,169,26,24,69,75,2,6,65,70,1905,1957,601,545
Rockwall,7,6152,2936,3216,2556,2754,195,241,28,28,109,137,3,5,45,51,2299,2564,637,652
Rockwall,8,7606,3747,3859,3212,3366,308,266,38,22,125,132,6,5,58,68,2968,3071,779,788
Rockwall,9,7431,3653,3778,3151,3171,285,299,33,32,119,193,1,3,64,80,2884,3066,769,712
Rockwall,10,7613,3781,3832,3235,3297,327,301,41,25,141,146,5,4,32,59,3164,3199,617,633
Rockwall,11,6820,3450,3370,3021,2939,266,263,38,19,96,115,4,3,25,31,2951,2906,499,464
Rockwall,12,6626,3279,3347,2959,2987,227,211,18,31,57,85,3,2,15,31,2883,2965,396,382
Rockwall,13,5557,2626,2931,2368,2641,152,146,23,28,56,92,0,4,27,20,2386,2686,240,245
Rockwall,14,4296,2062,2234,1903,2014,76,86,16,12,54,96,0,3,13,23,1905,2079,157,155
Rockwall,15,3348,1548,1800,1428,1642,48,53,14,11,45,78,0,3,13,13,1458,1677,90,123
Rockwall,16,2280,1031,1249,959,1175,19,39,8,7,37,21,0,3,8,4,984,1174,47,75
Rockwall,17,1311,536,775,507,726,10,19,3,6,10,18,1,0,5,6,503,732,33,43
Rockwall,18,1343,447,896,415,849,12,23,3,7,14,13,0,0,3,4,420,863,27,33
Runnels,5,575,307,268,276,245,14,5,7,6,2,5,0,0,8,7,155,146,152,122
Runnels,6,574,294,280,259,253,7,9,15,7,5,3,1,0,7,8,171,173,123,107
Runnels,7,592,308,284,284,261,12,4,6,4,4,9,0,0,2,6,180,184,128,100
Runnels,8,602,319,283,286,269,14,4,3,4,16,2,0,0,0,4,198,168,121,115
Runnels,9,499,255,244,239,228,7,2,5,8,2,4,0,0,2,2,158,149,97,95
Runnels,10,602,290,312,275,291,6,11,5,6,1,2,0,0,3,2,187,197,103,115
Runnels,11,653,319,334,297,306,6,6,11,4,3,15,0,1,2,2,217,228,102,106
Runnels,12,680,353,327,335,300,10,10,5,8,2,8,0,0,1,1,245,247,108,80
Runnels,13,719,371,348,336,331,12,11,2,2,18,2,0,0,3,2,283,265,88,83
Runnels,14,610,320,290,301,278,5,7,1,3,10,1,0,0,3,1,251,234,69,56
Runnels,15,534,259,275,256,265,1,7,1,2,0,0,0,0,1,1,205,223,54,52
Runnels,16,426,196,230,188,224,3,2,3,2,0,0,0,0,2,2,151,178,45,52
Runnels,17,266,123,143,110,135,5,1,4,5,1,1,1,0,2,1,111,123,12,20
Runnels,18,290,107,183,103,173,2,3,1,2,0,0,0,0,1,5,91,161,16,22
Rusk,5,3530,2255,1275,1635,992,537,214,33,22,9,9,6,3,35,35,1694,951,561,324
Rusk,6,3780,2285,1495,1674,1210,556,241,29,11,6,13,1,0,19,20,1802,1225,483,270
Rusk,7,3544,2065,1479,1532,1185,452,238,21,9,31,19,2,1,27,27,1634,1199,431,280
Rusk,8,3593,1991,1602,1557,1308,387,237,16,15,15,14,0,1,16,27,1599,1303,392,299
Rusk,9,3675,2138,1537,1633,1217,454,269,16,17,9,8,2,1,24,25,1691,1277,447,260
Rusk,10,3489,2010,1479,1517,1151,437,270,23,21,14,14,0,2,19,21,1647,1275,363,204
Rusk,11,3350,1886,1464,1416,1140,428,285,14,19,9,5,2,0,17,15,1622,1300,264,164
Rusk,12,3629,1861,1768,1443,1393,370,321,22,14,12,17,1,1,13,22,1646,1618,215,150
Rusk,13,3393,1715,1678,1367,1343,305,299,16,14,6,7,0,1,21,14,1557,1557,158,121
Rusk,14,2917,1415,1502,1175,1225,210,246,10,12,6,9,0,1,14,9,1308,1424,107,78
Rusk,15,2331,1110,1221,948,1018,141,184,7,3,3,5,1,0,10,11,1054,1173,56,48
Rusk,16,1608,760,848,661,715,81,116,5,6,0,3,1,0,12,8,738,830,22,18
Rusk,17,1010,435,575,369,483,53,86,4,0,1,1,0,0,8,5,421,561,14,14
Rusk,18,1098,415,683,353,560,56,107,4,5,1,3,0,0,1,8,388,672,27,11
Sabine,5,460,230,230,200,198,17,25,4,3,1,0,0,0,8,4,220,215,10,15
Sabine,6,480,238,242,209,217,23,21,0,0,2,0,2,0,2,4,219,224,19,18
Sabine,7,457,228,229,205,212,17,11,3,3,0,0,0,0,3,3,203,210,25,19
Sabine,8,466,213,253,184,228,21,21,2,1,1,0,1,0,4,3,194,244,19,9
Sabine,9,425,217,208,197,188,16,13,3,4,1,2,0,0,0,1,203,198,14,10
Sabine,10,525,253,272,222,244,22,25,4,0,3,2,0,0,2,1,243,257,10,15
Sabine,11,628,308,320,264,270,33,36,7,7,1,5,0,0,3,2,290,311,18,9
Sabine,12,867,436,431,395,401,32,16,5,7,0,5,0,0,4,2,424,426,12,5
Sabine,13,862,424,438,380,411,31,21,7,3,0,1,0,0,6,2,417,434,7,4
Sabine,14,914,451,463,421,435,25,17,3,5,1,0,0,0,1,6,440,448,11,15
Sabine,15,885,437,448,410,416,17,20,5,5,0,1,0,1,5,5,426,444,11,4
Sabine,16,670,365,305,349,284,10,12,3,2,0,2,0,0,3,5,357,302,8,3
Sabine,17,402,185,217,169,204,10,11,1,0,2,1,0,0,3,1,183,213,2,4
Sabine,18,364,135,229,128,206,4,19,0,0,1,1,0,1,2,2,133,219,2,10
San,5,345,165,180,116,130,48,43,0,0,0,2,0,0,1,5,151,164,14,16
San,6,469,238,231,176,170,59,48,0,1,2,1,0,0,1,11,222,215,16,16
San,7,378,197,181,140,123,50,52,5,4,1,0,0,0,1,2,167,167,30,14
San,8,364,156,208,103,157,50,44,2,0,0,1,0,0,1,6,137,180,19,28
San,9,365,187,178,144,133,36,39,0,2,0,1,0,0,7,3,169,159,18,19
San,10,434,198,236,153,186,42,46,0,1,0,0,0,0,3,3,182,227,16,9
San,11,556,281,275,205,193,62,76,6,1,0,2,0,0,8,3,250,262,31,13
San,12,699,347,352,253,260,76,87,9,0,2,1,0,0,7,4,329,342,18,10
San,13,663,330,333,273,256,51,70,3,0,1,3,0,0,2,4,317,322,13,11
San,14,606,316,290,257,236,57,49,0,5,0,0,0,0,2,0,305,280,11,10
San,15,548,260,288,219,230,38,56,2,0,0,0,0,0,1,2,252,287,8,1
San,16,453,216,237,188,201,28,34,0,1,0,0,0,0,0,1,212,234,4,3
San,17,283,129,154,109,125,16,26,1,0,0,1,0,0,3,2,126,153,3,1
San,18,314,118,196,98,145,16,47,2,2,0,0,0,0,2,2,116,190,2,6
San,5,1548,791,757,663,634,96,90,6,7,6,3,1,0,19,23,660,593,131,164
San,6,1554,766,788,665,670,63,83,13,9,3,4,1,1,21,21,631,656,135,132
San,7,1460,715,745,613,650,83,76,4,5,5,1,0,1,10,12,596,639,119,106
San,8,1474,708,766,608,672,76,67,7,6,2,3,0,0,15,18,603,628,105,138
San,9,1506,721,785,632,684,71,81,5,8,3,4,0,0,10,8,598,677,123,108
San,10,1687,838,849,745,711,69,105,7,11,5,10,0,0,12,12,745,722,93,127
San,11,1715,823,892,721,779,78,86,12,9,4,5,0,1,8,12,715,777,108,115
San,12,2378,1193,1185,1007,1004,137,141,23,13,4,4,0,3,22,20,1087,1109,106,76
San,13,2354,1186,1168,1047,1021,112,116,9,12,5,6,1,0,12,13,1096,1089,90,79
San,14,2100,1015,1085,893,976,81,79,16,9,5,8,1,0,19,13,956,1019,59,66
San,15,1684,832,852,757,753,58,71,4,7,6,8,1,1,6,12,800,826,32,26
San,16,1186,608,578,541,522,56,46,6,1,2,1,0,0,3,8,590,559,18,19
San,17,725,334,391,306,345,24,39,1,3,0,2,0,0,3,2,324,373,10,18
San,18,584,275,309,243,262,24,41,1,0,0,3,0,0,7,3,263,299,12,10
San,5,4090,2160,1930,1987,1808,62,27,29,25,31,23,6,4,45,43,765,651,1395,1279
San,6,4409,2289,2120,2151,2014,53,35,31,15,20,22,2,5,32,29,845,785,1444,1335
San,7,4504,2339,2165,2222,2010,52,60,21,27,16,38,5,7,23,23,887,842,1452,1323
San,8,4550,2299,2251,2170,2121,64,46,25,16,21,47,2,1,17,20,884,903,1415,1348
San,9,4019,2090,1929,1940,1825,70,28,22,26,26,34,6,1,26,15,834,758,1256,1171
San,10,4005,1982,2023,1868,1904,43,43,24,25,23,29,3,5,21,17,831,852,1151,1171
San,11,3836,1869,1967,1767,1842,41,35,23,24,26,33,2,5,10,28,887,857,982,1110
San,12,4118,1999,2119,1893,2011,44,32,27,21,21,41,1,2,13,12,1044,1103,955,1016
San,13,3682,1844,1838,1757,1728,38,31,21,28,15,31,2,2,11,18,1004,1002,840,836
San,14,3157,1568,1589,1492,1522,21,15,28,14,15,25,0,1,12,12,882,859,686,730
San,15,2752,1286,1466,1233,1400,19,13,15,8,5,26,4,3,10,16,712,822,574,644
San,16,1795,817,978,792,950,7,8,7,2,3,8,3,1,5,9,514,568,303,410
San,17,1193,512,681,491,663,10,8,2,5,7,1,2,0,0,4,313,415,199,266
San,18,1004,396,608,381,584,9,7,2,8,1,5,0,1,3,3,241,349,155,259
San,5,458,331,127,269,113,59,3,2,7,0,1,0,0,1,3,192,64,139,63
San,6,483,346,137,287,122,55,4,1,4,3,0,0,0,0,7,209,83,137,54
San,7,417,284,133,222,124,55,2,5,2,1,1,0,0,1,4,186,82,98,51
San,8,286,169,117,155,110,10,0,1,2,1,3,0,0,2,2,88,77,81,40
San,9,231,107,124,103,119,0,1,0,2,1,1,0,0,3,1,73,85,34,39
San,10,327,166,161,160,147,2,1,3,5,0,2,0,0,1,6,118,110,48,51
San,11,316,174,142,164,138,2,2,2,1,3,1,0,0,3,0,118,102,56,40
San,12,375,169,206,159,198,2,0,6,3,0,1,0,0,2,4,121,167,48,39
San,13,377,173,204,165,196,2,0,4,3,0,2,0,0,2,3,141,171,32,33
San,14,403,204,199,196,196,1,0,4,2,0,0,0,0,3,1,174,179,30,20
San,15,402,194,208,187,200,0,2,6,4,0,0,0,0,1,2,167,177,27,31
San,16,254,130,124,128,119,0,0,2,0,0,3,0,0,0,2,110,116,20,8
San,17,182,83,99,83,98,0,1,0,0,0,0,0,0,0,0,79,92,4,7
San,18,208,65,143,63,141,0,1,1,1,0,0,0,0,1,0,59,127,6,16
Schleicher,5,136,68,68,64,63,1,1,1,1,0,1,0,0,2,2,28,26,40,42
Schleicher,6,157,72,85,64,78,0,2,2,2,2,0,0,0,4,3,25,31,47,54
Schleicher,7,191,101,90,97,84,2,2,1,1,0,0,0,0,1,3,31,38,70,52
Schleicher,8,198,105,93,102,93,1,0,0,0,0,0,0,0,2,0,34,30,71,63
Schleicher,9,144,70,74,68,74,0,0,1,0,0,0,0,0,1,0,30,31,40,43
Schleicher,10,172,81,91,80,85,0,2,1,0,0,1,0,0,0,3,37,37,44,54
Schleicher,11,159,80,79,73,65,3,4,3,7,0,2,0,0,1,1,40,38,40,41
Schleicher,12,179,92,87,85,85,6,1,0,0,1,0,0,0,0,1,55,50,37,37
Schleicher,13,162,78,84,76,80,0,2,2,1,0,0,0,0,0,1,43,50,35,34
Schleicher,14,198,104,94,104,90,0,1,0,0,0,1,0,0,0,2,61,61,43,33
Schleicher,15,152,83,69,81,68,1,0,0,0,0,0,0,0,1,1,54,47,29,22
Schleicher,16,107,49,58,47,55,1,0,0,1,1,0,0,0,0,2,33,40,16,18
Schleicher,17,51,15,36,15,34,0,1,0,1,0,0,0,0,0,0,7,29,8,7
Schleicher,18,44,23,21,23,20,0,1,0,0,0,0,0,0,0,0,10,14,13,7
Scurry,5,1137,653,484,541,442,82,15,8,11,9,2,0,0,13,14,369,239,284,245
Scurry,6,1174,705,469,589,433,75,19,20,6,11,2,0,0,10,9,376,265,329,204
Scurry,7,1061,617,444,517,417,71,11,13,8,3,5,0,0,13,3,361,259,256,185
Scurry,8,1210,722,488,628,459,72,12,7,6,10,9,0,0,5,2,410,271,312,217
Scurry,9,1026,621,405,543,379,59,13,4,5,5,6,0,0,10,2,354,237,267,168
Scurry,10,1004,619,385,529,364,64,10,15,4,3,4,0,0,8,3,369,247,250,138
Scurry,11,985,539,446,465,423,54,11,11,4,7,3,0,1,2,4,338,288,201,158
Scurry,12,1051,555,496,516,476,29,9,5,6,1,0,3,1,1,4,367,350,188,146
Scurry,13,954,518,436,478,414,27,14,6,5,3,0,0,0,4,3,364,317,154,119
Scurry,14,775,386,389,355,369,19,10,7,5,2,2,1,0,2,3,280,304,106,85
Scurry,15,585,284,301,273,283,6,11,3,4,1,1,0,0,1,2,211,233,73,68
Scurry,16,467,202,265,191,252,8,7,1,1,0,0,0,0,2,5,152,220,50,45
Scurry,17,344,126,218,125,205,1,8,0,2,0,1,0,0,0,2,105,182,21,36
Scurry,18,369,128,241,119,229,3,7,3,0,1,1,0,0,2,4,102,220,26,21
Shackelford,5,142,67,75,59,68,2,3,1,1,0,1,0,0,5,2,53,63,14,12
Shackelford,6,178,80,98,78,94,1,0,0,0,1,4,0,0,0,0,68,91,12,7
Shackelford,7,186,103,83,98,78,4,3,1,0,0,0,0,0,0,2,85,74,18,9
Shackelford,8,146,67,79,61,77,1,0,1,0,0,1,0,0,4,1,61,70,6,9
Shackelford,9,188,89,99,87,97,2,1,0,0,0,0,0,0,0,1,77,84,12,15
Shackelford,10,180,87,93,80,90,6,0,1,1,0,2,0,0,0,0,82,83,5,10
Shackelford,11,179,93,86,89,85,2,1,1,0,0,0,0,0,1,0,74,74,19,12
Shackelford,12,280,130,150,128,146,0,1,1,1,1,2,0,0,0,0,115,140,15,10
Shackelford,13,268,136,132,133,131,0,0,1,0,0,0,0,0,2,1,131,125,5,7
Shackelford,14,192,81,111,80,109,0,1,0,0,0,0,0,0,1,1,78,105,3,6
Shackelford,15,164,87,77,86,74,0,0,1,2,0,1,0,0,0,0,83,73,4,4
Shackelford,16,126,56,70,55,68,0,0,1,0,0,0,0,0,0,2,51,66,5,4
Shackelford,17,110,55,55,54,54,1,1,0,0,0,0,0,0,0,0,51,54,4,1
Shackelford,18,75,26,49,25,46,0,1,1,0,0,0,0,0,0,2,25,48,1,1
Shelby,5,1408,720,688,526,522,156,139,12,7,10,10,2,1,14,9,533,525,187,163
Shelby,6,1586,793,793,580,598,154,169,9,4,41,11,2,0,7,11,617,657,176,136
Shelby,7,1426,723,703,577,505,108,162,5,14,25,12,0,0,8,10,564,553,159,150
Shelby,8,1418,728,690,571,530,124,131,7,12,19,13,0,0,7,4,533,567,195,123
Shelby,9,1506,730,776,601,622,104,133,9,4,10,10,0,1,6,6,537,610,193,166
Shelby,10,1522,765,757,641,591,106,148,5,5,6,4,0,1,7,8,593,636,172,121
Shelby,11,1496,735,761,582,572,141,169,4,5,6,11,0,0,2,4,605,668,130,93
Shelby,12,1673,836,837,645,650,174,162,6,6,4,8,0,0,7,11,745,774,91,63
Shelby,13,1569,769,800,623,623,130,160,3,4,6,5,0,2,7,6,704,756,65,44
Shelby,14,1405,670,735,559,592,97,125,5,7,3,6,1,0,5,5,623,709,47,26
Shelby,15,1111,541,570,479,492,55,68,3,3,0,5,0,0,4,2,506,557,35,13
Shelby,16,845,379,466,336,384,35,79,2,1,4,1,0,0,2,1,366,457,13,9
Shelby,17,633,301,332,264,277,29,47,5,2,0,0,0,0,3,6,294,316,7,16
Shelby,18,488,181,307,154,250,23,52,1,2,0,1,0,0,3,2,167,299,14,8
Sherman,5,180,95,85,90,74,2,3,2,4,0,2,0,0,1,2,42,34,53,51
Sherman,6,185,103,82,97,80,2,0,0,1,2,0,0,0,2,1,44,50,59,32
Sherman,7,169,84,85,77,80,6,1,0,0,1,2,0,0,0,2,42,48,42,37
Sherman,8,179,89,90,88,88,0,0,1,1,0,0,0,0,0,1,44,42,45,48
Sherman,9,162,93,69,84,64,1,0,6,3,1,1,0,0,1,1,44,35,49,34
Sherman,10,198,102,96,93,95,6,0,0,0,1,0,0,0,2,1,62,47,40,49
Sherman,11,230,111,119,107,113,3,2,0,2,1,1,0,0,0,1,63,71,48,48
Sherman,12,191,103,88,95,85,2,0,2,3,1,0,0,0,3,0,71,62,32,26
Sherman,13,190,107,83,104,80,1,0,1,1,1,1,0,0,0,1,60,58,47,25
Sherman,14,138,73,65,68,62,2,2,1,1,1,0,0,0,1,0,56,54,17,11
Sherman,15,110,53,57,53,55,0,0,0,0,0,2,0,0,0,0,46,52,7,5
Sherman,16,85,36,49,35,48,0,0,1,0,0,0,0,0,0,1,32,40,4,9
Sherman,17,57,32,25,31,25,1,0,0,0,0,0,0,0,0,0,23,21,9,4
Sherman,18,67,25,42,25,41,0,0,0,1,0,0,0,0,0,0,21,41,4,1
Smith,5,15620,7705,7915,5574,5714,1734,1811,95,81,108,120,5,10,189,179,5749,5892,1956,2023
Smith,6,16444,7971,8473,6066,6328,1545,1777,89,72,120,125,11,11,140,160,6046,6576,1925,1897
Smith,7,15097,7284,7813,5775,5929,1206,1504,65,80,120,163,11,8,107,129,5550,6165,1734,1648
Smith,8,14293,6924,7369,5470,5591,1151,1432,69,66,168,180,5,6,61,94,5338,5834,1586,1535
Smith,9,12730,6115,6615,4893,5102,964,1178,63,63,148,185,3,6,44,81,4697,5221,1418,1394
Smith,10,13560,6443,7117,5134,5446,1053,1359,56,63,144,195,6,6,50,48,5159,5786,1284,1331
Smith,11,13161,6295,6866,5028,5265,1055,1316,39,47,111,134,4,58,58,46,5228,5842,1067,1024
Smith,12,14127,6787,7340,5453,5776,1148,1351,55,56,83,98,0,2,48,57,5895,6603,892,737
Smith,13,13830,6426,7404,5191,5825,1073,1353,42,55,67,107,5,4,48,60,5816,6799,610,605
Smith,14,11666,5444,6222,4467,5013,860,1049,33,32,46,70,2,7,36,51,5065,5850,379,372
Smith,15,9618,4353,5265,3758,4417,516,738,23,33,24,39,0,2,32,36,4116,5016,237,249
Smith,16,7083,3136,3947,2742,3389,336,476,20,16,22,36,1,1,15,29,2984,3799,152,148
Smith,17,4769,2035,2734,1783,2318,193,369,7,13,28,16,5,0,19,18,1924,2641,111,93
Smith,18,4756,1786,2970,1562,2500,184,417,10,10,21,18,0,2,9,23,1719,2862,67,108
Somervell,5,496,276,220,256,198,2,7,6,5,4,4,0,0,8,6,209,157,67,63
Somervell,6,496,228,268,210,250,5,3,4,7,1,4,0,1,8,3,169,205,59,63
Somervell,7,494,248,246,238,236,0,1,4,5,2,2,0,0,4,2,177,180,71,66
Somervell,8,541,268,273,249,251,6,5,7,3,2,9,0,0,4,5,199,204,69,69
Somervell,9,540,250,290,234,268,1,3,3,5,7,5,0,0,5,9,190,222,60,68
Somervell,10,597,285,312,264,295,8,4,5,6,5,1,1,0,2,6,246,256,39,56
Somervell,11,629,311,318,298,310,3,0,3,4,4,1,0,0,3,3,246,277,65,41
Somervell,12,660,334,326,321,309,2,2,3,6,3,3,0,0,5,6,295,295,39,31
Somervell,13,645,324,321,310,314,2,0,5,6,0,0,0,0,7,1,295,293,29,28
Somervell,14,587,298,289,286,278,4,0,2,7,0,2,1,0,5,2,265,268,33,21
Somervell,15,418,210,208,206,203,1,0,2,1,0,2,0,0,1,2,201,197,9,11
Somervell,16,281,142,139,136,135,0,0,3,1,2,1,0,0,1,2,134,126,8,13
Somervell,17,211,95,116,94,112,0,0,0,1,0,0,0,0,1,3,81,110,14,6
Somervell,18,208,75,133,71,129,0,1,1,0,0,0,0,0,3,3,69,131,6,2
Starr,5,5193,2635,2558,2602,2530,15,7,8,9,5,5,1,0,4,7,76,74,2559,2484
Starr,6,4719,2453,2266,2428,2252,5,2,13,8,4,2,0,1,3,1,94,76,2359,2190
Starr,7,3890,2008,1882,1977,1862,9,3,3,12,6,5,2,0,11,0,79,54,1929,1828
Starr,8,3830,1937,1893,1903,1871,8,4,11,8,9,5,0,0,6,5,72,57,1865,1836
Starr,9,3682,1789,1893,1765,1868,6,2,11,13,5,8,0,1,2,1,51,71,1738,1822
Starr,10,3782,1833,1949,1812,1928,5,5,8,7,6,7,0,0,2,2,65,69,1768,1880
Starr,11,3344,1503,1841,1481,1830,11,5,7,1,3,4,1,0,0,1,79,80,1424,1761
Starr,12,2908,1323,1585,1305,1570,6,4,7,4,2,4,0,0,3,3,50,56,1273,1529
Starr,13,2429,1127,1302,1115,1283,0,4,3,3,6,7,0,1,3,4,66,48,1061,1254
Starr,14,2196,952,1244,942,1230,2,2,4,6,3,4,0,0,1,2,42,54,910,1190
Starr,15,1878,804,1074,799,1068,1,1,2,1,2,3,0,0,0,1,27,46,777,1028
Starr,16,1384,633,751,629,745,1,0,2,2,1,2,0,0,0,2,43,48,590,703
Starr,17,992,427,565,422,563,1,1,0,0,1,0,0,0,3,1,48,35,379,530
Starr,18,807,308,499,301,492,0,2,1,3,3,0,0,0,3,2,56,77,252,422
Stephens,5,624,402,222,349,210,33,3,8,3,6,3,0,0,6,3,263,151,139,71
Stephens,6,607,373,234,328,223,31,2,6,6,2,1,1,0,5,2,245,158,128,76
Stephens,7,572,314,258,289,251,16,4,7,3,1,0,0,0,1,0,223,179,91,79
Stephens,8,613,356,257,320,235,15,5,4,6,14,5,0,1,3,5,253,180,103,77
Stephens,9,522,281,241,259,229,8,5,3,3,6,2,0,0,5,2,206,194,75,47
Stephens,10,499,258,241,237,232,13,1,4,6,2,2,0,0,2,0,200,182,58,59
Stephens,11,535,298,237,279,230,11,2,1,4,2,0,0,0,5,1,222,193,76,44
Stephens,12,676,326,350,319,336,4,5,0,3,0,4,0,0,3,2,271,294,55,56
Stephens,13,612,299,313,280,306,8,4,7,2,1,0,0,0,3,1,250,276,49,37
Stephens,14,575,286,289,274,274,4,5,7,2,0,0,0,1,1,7,264,265,22,24
Stephens,15,462,221,241,215,234,1,5,2,0,2,1,0,0,1,1,202,232,19,9
Stephens,16,351,170,181,162,174,4,4,0,1,4,2,0,0,0,0,160,170,10,11
Stephens,17,230,98,132,94,126,2,3,0,1,1,0,0,0,1,2,90,124,8,8
Stephens,18,243,78,165,78,159,0,2,0,1,0,0,0,0,0,3,71,153,7,12
Sterling,5,72,44,28,41,26,0,1,1,1,0,0,0,0,2,0,21,15,23,13
Sterling,6,61,32,29,31,26,1,1,0,1,0,1,0,0,0,0,18,17,14,12
Sterling,7,87,43,44,37,43,2,0,2,0,2,0,0,0,0,1,21,20,22,24
Sterling,8,90,45,45,42,42,0,1,2,1,0,0,0,0,1,1,23,30,22,15
Sterling,9,90,48,42,45,41,3,0,0,0,0,0,0,1,0,0,27,28,21,14
Sterling,10,78,35,43,32,41,2,0,0,1,0,1,0,0,1,0,27,24,8,19
Sterling,11,69,35,34,34,32,0,1,1,0,0,0,0,0,0,1,21,19,14,15
Sterling,12,82,45,37,43,34,2,2,0,1,0,0,0,0,0,0,29,22,16,15
Sterling,13,93,45,48,44,45,0,0,0,0,1,1,0,0,0,2,30,41,15,7
Sterling,14,48,23,25,20,23,1,0,1,1,0,0,0,0,1,1,18,19,5,6
Sterling,15,47,28,19,26,17,0,0,2,2,0,0,0,0,0,0,19,14,9,5
Sterling,16,31,12,19,11,18,0,1,1,0,0,0,0,0,0,0,7,14,5,5
Sterling,17,26,12,14,12,14,0,0,0,0,0,0,0,0,0,0,8,10,4,4
Sterling,18,34,10,24,7,21,1,1,2,0,0,0,0,0,0,2,6,18,4,6
Stonewall,5,49,29,20,23,18,5,1,0,1,0,0,0,0,1,0,23,13,6,7
Stonewall,6,72,39,33,34,29,4,3,1,0,0,0,0,0,0,1,25,28,14,5
Stonewall,7,41,20,21,20,19,0,1,0,0,0,1,0,0,0,0,16,12,4,9
Stonewall,8,85,35,50,34,43,0,1,0,2,1,3,0,0,0,1,28,32,7,18
Stonewall,9,56,28,28,26,26,2,1,0,0,0,0,0,0,0,1,21,25,7,3
Stonewall,10,74,42,32,34,30,2,0,3,1,2,1,0,0,1,0,30,23,12,9
Stonewall,11,88,46,42,43,38,2,2,0,0,0,0,0,0,1,2,41,34,5,8
Stonewall,12,95,48,47,44,45,3,2,1,0,0,0,0,0,0,0,39,44,9,3
Stonewall,13,103,51,52,49,51,0,0,2,1,0,0,0,0,0,0,45,44,6,8
Stonewall,14,92,45,47,44,46,0,0,0,0,0,0,0,0,1,1,41,44,4,3
Stonewall,15,93,38,55,36,49,1,3,1,2,0,0,0,0,0,1,36,51,2,4
Stonewall,16,58,27,31,25,30,2,0,0,1,0,0,0,0,0,0,25,28,2,3
Stonewall,17,43,16,27,15,25,0,1,1,0,0,0,0,0,0,1,15,26,1,1
Stonewall,18,70,29,41,29,40,0,0,0,0,0,0,0,0,0,1,26,39,3,2
Sutton,5,186,107,79,101,73,2,1,1,2,2,1,0,0,1,2,27,25,80,54
Sutton,6,227,118,109,107,105,3,1,5,1,1,0,0,1,2,1,40,33,78,76
Sutton,7,214,126,88,122,84,1,1,3,1,0,1,0,0,0,1,36,37,90,51
Sutton,8,191,92,99,90,95,1,1,1,2,0,0,0,0,0,1,24,30,68,69
Sutton,9,200,96,104,93,101,2,1,0,0,0,1,0,0,1,1,28,33,68,71
Sutton,10,268,144,124,141,122,2,1,0,1,1,0,0,0,0,0,43,42,101,82
Sutton,11,239,115,124,111,117,1,2,1,1,0,2,0,0,2,2,33,58,82,66
Sutton,12,270,142,128,136,125,2,0,2,1,1,1,0,0,1,1,63,57,79,71
Sutton,13,273,133,140,130,139,0,0,3,0,0,1,0,0,0,0,61,70,72,70
Sutton,14,211,106,105,103,101,0,1,1,1,1,0,0,0,1,2,57,41,49,64
Sutton,15,194,100,94,95,90,2,1,1,3,1,0,0,0,1,0,54,51,46,43
Sutton,16,112,56,56,53,56,1,0,2,0,0,0,0,0,0,0,36,36,20,20
Sutton,17,73,44,29,44,28,0,0,0,0,0,0,0,0,0,1,26,17,18,12
Sutton,18,97,37,60,37,59,0,0,0,1,0,0,0,0,0,0,16,35,21,25
Swisher,5,503,332,171,263,150,54,10,6,4,4,2,0,0,5,5,154,75,178,96
Swisher,6,534,330,204,253,185,68,9,4,4,1,0,1,0,3,6,172,79,158,125
Swisher,7,502,301,201,233,170,55,10,5,8,1,6,1,1,6,6,147,94,154,107
Swisher,8,436,237,199,204,176,27,12,2,3,0,6,0,0,4,2,110,125,127,74
Swisher,9,395,220,175,184,153,29,13,5,4,0,3,0,0,2,2,119,107,101,68
Swisher,10,401,213,188,172,166,30,9,8,6,0,4,0,0,3,3,125,89,88,99
Swisher,11,442,229,213,207,193,18,12,3,5,0,0,0,1,1,2,136,119,93,94
Swisher,12,412,209,203,186,190,12,6,3,6,4,1,0,0,4,0,130,128,79,75
Swisher,13,406,202,204,185,192,11,8,3,3,0,0,0,0,3,1,131,136,71,68
Swisher,14,383,191,192,180,177,7,10,2,1,1,2,0,0,1,2,140,148,51,44
Swisher,15,303,141,162,136,151,2,5,0,4,1,2,0,0,2,0,105,125,36,37
Swisher,16,242,120,122,111,112,6,7,1,1,1,0,0,0,1,2,90,86,30,36
Swisher,17,186,69,117,66,112,3,3,0,0,0,1,0,0,0,1,51,94,18,23
Swisher,18,197,85,112,80,107,2,0,1,2,0,0,0,1,2,2,73,99,12,13
Tarrant,5,138359,68820,69539,48999,48538,12651,13637,766,781,4018,4314,185,192,2201,2077,43946,45063,24874,24476
Tarrant,6,158002,78165,79837,55960,55282,14641,16496,781,770,4702,5004,221,225,1860,2060,52844,55330,25321,24507
Tarrant,7,153541,75410,78131,55061,54416,13222,15808,714,689,4745,5397,213,240,1455,1581,51476,55360,23934,22771
Tarrant,8,149137,72721,76416,53249,52991,12808,15500,759,700,4383,5464,216,199,1306,1562,49628,54093,23093,22323
Tarrant,9,135763,65586,70177,48080,49007,11346,13846,647,637,4287,5178,170,160,1056,1349,44727,49320,20859,20857
Tarrant,10,139008,67740,71268,50465,51155,10995,13102,624,712,4482,5022,143,173,1031,1104,48984,52067,18756,19201
Tarrant,11,130731,64075,66656,48281,48693,10411,12106,568,540,3899,4182,143,173,773,962,47679,51017,16396,15639
Tarrant,12,129703,63727,65976,49423,50079,9646,11007,516,556,3262,3393,143,124,737,817,51170,53971,12557,12005
Tarrant,13,108986,52298,56688,41285,43675,7192,8833,450,397,2631,3057,112,158,628,568,43824,47923,8474,8765
Tarrant,14,82444,38044,44400,30618,34778,4528,6276,312,282,2100,2551,59,78,427,435,32472,38354,5572,6046
Tarrant,15,61651,28167,33484,23469,27327,2801,3956,183,226,1424,1666,44,43,246,266,24561,29323,3606,4161
Tarrant,16,39586,17249,22337,14476,18457,1587,2448,119,114,921,1091,26,28,120,199,15265,19687,1984,2650
Tarrant,17,25215,10138,15077,8646,12718,853,1578,53,89,500,569,19,13,67,110,8962,13332,1176,1745
Tarrant,18,25607,8935,16672,7801,14480,703,1511,55,70,315,514,3,7,58,90,8000,15045,935,1627
Taylor,5,14085,7140,6945,5916,5756,693,622,64,65,209,267,9,5,249,230,5417,5342,1723,1603
Taylor,6,10796,5576,5220,4553,4347,654,478,62,67,144,174,10,13,153,141,4202,3749,1374,1471
Taylor,7,9389,4675,4714,3910,4047,459,360,60,51,114,127,12,7,120,122,3347,3363,1328,1351
Taylor,8,8830,4392,4438,3717,3752,418,388,47,52,113,146,6,9,91,91,3179,3165,1213,1273
Taylor,9,6814,3367,3447,2904,2972,296,270,28,30,69,98,5,9,65,68,2475,2477,892,970
Taylor,10,6597,3235,3362,2766,2949,278,213,35,41,100,95,8,6,48,58,2497,2570,738,792
Taylor,11,6753,3241,3512,2867,3109,234,243,35,30,63,75,3,3,39,52,2527,2770,714,742
Taylor,12,7798,3692,4106,3301,3687,242,246,56,39,42,91,7,4,44,39,3030,3376,662,730
Taylor,13,7242,3457,3785,3113,3396,222,218,53,36,33,105,2,1,34,29,2935,3241,522,544
Taylor,14,5769,2610,3159,2376,2823,152,149,23,30,33,123,1,3,25,31,2222,2667,388,492
Taylor,15,4908,2211,2697,2027,2461,109,133,18,21,28,55,1,3,28,24,1896,2320,315,377
Taylor,16,3698,1583,2115,1470,1939,70,101,15,13,19,43,2,1,7,18,1410,1868,173,247
Taylor,17,2647,1086,1561,1021,1463,35,41,9,19,10,19,0,2,11,17,978,1406,108,155
Taylor,18,2761,933,1828,882,1717,26,42,9,22,12,43,1,0,3,4,857,1693,76,135
Terrell,5,31,18,13,14,9,1,0,2,4,1,0,0,0,0,0,7,7,11,6
Terrell,6,30,10,20,8,18,0,0,0,1,2,0,0,0,0,1,7,5,3,15
Terrell,7,43,24,19,21,19,1,0,1,0,1,0,0,0,0,0,9,11,15,8
Terrell,8,43,19,24,18,23,1,1,0,0,0,0,0,0,0,0,10,13,9,11
Terrell,9,52,28,24,25,24,1,0,2,0,0,0,0,0,0,0,8,14,20,10
Terrell,10,45,26,19,24,15,0,1,2,3,0,0,0,0,0,0,3,7,23,12
Terrell,11,47,26,21,22,19,4,0,0,1,0,0,0,0,0,1,11,7,15,14
Terrell,12,41,18,23,17,21,0,0,1,2,0,0,0,0,0,0,10,10,8,13
Terrell,13,53,31,22,29,21,0,0,1,1,1,0,0,0,0,0,18,11,13,11
Terrell,14,74,38,36,38,35,0,0,0,1,0,0,0,0,0,0,24,22,14,14
Terrell,15,67,32,35,32,34,0,0,0,0,0,0,0,0,0,1,18,18,14,17
Terrell,16,41,20,21,20,21,0,0,0,0,0,0,0,0,0,0,10,9,10,12
Terrell,17,22,11,11,11,10,0,0,0,0,0,0,0,0,0,1,5,2,6,9
Terrell,18,42,15,27,13,25,1,0,0,1,0,0,0,0,1,1,8,16,7,11
Terry,5,810,490,320,401,296,68,14,7,4,2,3,1,0,11,3,201,99,289,221
Terry,6,904,525,379,456,348,45,9,11,8,5,8,0,1,8,5,225,149,300,230
Terry,7,836,490,346,453,316,30,16,2,2,0,5,0,0,5,7,175,133,315,213
Terry,8,793,465,328,417,300,40,17,3,1,2,4,0,2,3,4,193,112,272,216
Terry,9,622,338,284,302,266,27,10,2,5,6,1,0,0,1,2,164,122,174,162
Terry,10,673,394,279,361,257,22,9,7,10,2,2,0,0,2,1,177,110,217,169
Terry,11,699,355,344,322,327,23,7,7,5,1,1,1,1,1,3,172,151,183,193
Terry,12,744,383,361,356,338,17,13,4,5,4,3,0,0,2,2,194,178,189,183
Terry,13,679,337,342,313,316,13,12,6,8,3,2,0,0,2,4,181,195,156,147
Terry,14,546,266,280,254,264,8,9,2,3,0,1,0,1,2,2,166,179,100,101
Terry,15,440,202,238,190,219,3,12,4,2,0,0,0,0,5,5,120,147,82,91
Terry,16,356,156,200,146,187,6,9,2,2,1,0,0,0,1,2,105,148,51,52
Terry,17,274,111,163,109,158,1,3,0,1,1,0,0,0,0,1,73,111,38,52
Terry,18,245,80,165,77,159,2,3,1,2,0,1,0,0,0,0,63,136,17,29
Throckmorton,5,62,39,23,36,20,0,1,1,1,2,0,0,0,0,1,34,17,5,6
Throckmorton,6,66,37,29,37,28,0,1,0,0,0,0,0,0,0,0,34,19,3,10
Throckmorton,7,61,29,32,29,30,0,1,0,0,0,0,0,0,0,1,29,27,0,5
Throckmorton,8,87,35,52,35,50,0,0,0,0,0,1,0,0,0,1,29,40,6,12
Throckmorton,9,67,32,35,30,33,1,0,1,2,0,0,0,0,0,0,24,27,8,8
Throckmorton,10,76,35,41,35,38,0,2,0,1,0,0,0,0,0,0,28,30,7,11
Throckmorton,11,108,42,66,42,65,0,1,0,0,0,0,0,0,0,0,37,61,5,5
Throckmorton,12,119,59,60,59,56,0,0,0,2,0,0,0,0,0,2,54,55,5,5
Throckmorton,13,112,55,57,53,56,0,0,1,0,0,1,0,0,1,0,53,54,2,3
Throckmorton,14,111,56,55,54,55,0,0,0,0,0,0,0,0,2,0,50,51,6,4
Throckmorton,15,97,49,48,49,46,0,0,0,2,0,0,0,0,0,0,46,42,3,6
Throckmorton,16,85,37,48,33,46,2,0,2,1,0,1,0,0,0,0,35,46,2,2
Throckmorton,17,70,34,36,32,34,0,0,1,2,0,0,0,0,1,0,33,35,1,1
Throckmorton,18,57,22,35,22,34,0,0,0,0,0,0,0,0,0,1,21,34,1,1
Titus,5,2245,1140,1105,963,941,108,99,36,40,26,11,0,2,7,12,549,487,591,618
Titus,6,2212,1068,1144,881,935,121,140,30,41,22,15,7,3,7,10,510,565,558,579
Titus,7,1784,858,926,727,775,82,98,28,26,6,12,4,3,11,12,430,480,428,446
Titus,8,1881,854,1027,737,876,79,93,23,29,5,11,1,2,9,16,450,540,404,487
Titus,9,1923,965,958,815,809,91,103,30,16,13,20,1,0,15,10,504,500,461,458
Titus,10,2051,1010,1041,866,869,88,123,33,29,14,11,2,0,7,9,533,600,477,441
Titus,11,1955,1009,946,865,791,100,108,25,26,13,10,1,4,5,7,566,615,443,331
Titus,12,1919,961,958,836,797,90,124,21,20,8,10,3,1,3,6,647,723,314,235
Titus,13,1666,810,856,706,727,72,98,8,12,9,12,1,1,14,6,592,694,218,162
Titus,14,1602,765,837,664,703,74,89,8,10,9,27,3,2,7,6,636,731,129,106
Titus,15,1218,555,663,506,582,36,61,6,7,2,8,0,1,5,4,476,595,79,68
Titus,16,822,387,435,330,375,32,50,8,2,15,3,0,0,2,5,349,393,38,42
Titus,17,519,232,287,197,260,11,21,8,1,12,2,0,0,4,3,209,273,23,14
Titus,18,550,212,338,189,303,21,27,2,4,0,3,0,0,0,1,200,318,12,20
Tom,5,9195,4954,4241,4272,3721,346,271,55,61,100,61,9,10,172,117,2980,2319,1974,1922
Tom,6,9384,4887,4497,4312,4073,293,211,57,56,105,70,10,7,110,80,2819,2457,2068,2040
Tom,7,8941,4684,4257,4240,3830,229,169,52,47,80,127,5,5,78,79,2574,2414,2110,1843
Tom,8,7760,3940,3820,3538,3470,214,157,67,36,58,88,13,9,50,60,2255,2120,1685,1700
Tom,9,5990,3066,2924,2771,2691,161,90,33,36,42,57,8,9,51,41,1815,1643,1251,1281
Tom,10,6007,2909,3098,2678,2851,106,101,40,49,45,43,4,4,36,50,1698,1790,1211,1308
Tom,11,6157,2924,3233,2713,3002,99,108,41,39,36,42,5,4,30,38,1822,2005,1102,1228
Tom,12,6993,3370,3623,3129,3391,129,124,42,51,36,29,2,3,32,25,2210,2415,1160,1208
Tom,13,6648,3069,3579,2869,3315,112,132,38,41,20,54,0,4,30,33,2153,2537,916,1042
Tom,14,5737,2762,2975,2578,2778,110,113,28,21,16,32,4,3,26,28,2021,2157,741,818
Tom,15,4527,2084,2443,1964,2305,68,66,18,26,11,24,1,0,22,22,1580,1853,504,590
Tom,16,3205,1419,1786,1342,1689,39,37,12,16,5,20,1,1,20,23,1131,1384,288,402
Tom,17,2421,1004,1417,944,1335,33,42,9,9,3,9,0,0,15,22,818,1100,186,317
Tom,18,2311,862,1449,829,1340,14,41,11,10,2,12,2,1,4,45,668,1157,194,292
Travis,5,81417,41153,40264,31223,30949,4203,4049,644,610,3708,3294,32,58,1343,1304,24365,24237,16788,16027
Travis,6,126408,65409,60999,50683,47748,6035,5409,744,662,6194,5408,90,89,1663,1683,43601,41378,21808,19621
Travis,7,123694,64726,58968,51724,46896,5120,4821,814,623,5437,5073,107,90,1524,1465,43090,40100,21636,18868
Travis,8,107611,56175,51436,45272,40994,4647,4347,716,641,4259,4165,111,73,1170,1216,36929,34345,19246,17091
Travis,9,92282,47644,44638,38640,35165,3646,3729,589,671,3775,4056,59,62,935,955,31606,29748,16038,14890
Travis,10,86635,44559,42076,36313,33457,3499,3746,553,510,3395,3570,53,39,746,754,31020,29122,13539,12954
Travis,11,72855,37131,35724,30412,28688,3247,3506,470,487,2437,2472,40,43,525,528,26142,25256,10989,10468
Travis,12,69604,34437,35167,28613,28832,3118,3346,397,408,1847,2066,29,38,433,477,25641,26277,8796,8890
Travis,13,61109,29455,31654,24652,26165,2752,3094,310,287,1322,1718,24,32,395,358,23055,24681,6400,6973
Travis,14,47571,22573,24998,19368,20971,1755,2136,200,226,997,1351,12,14,241,300,18432,20130,4141,4868
Travis,15,31817,14936,16881,12913,14253,1016,1374,124,112,736,955,15,12,132,175,12442,13885,2494,2996
Travis,16,18774,8478,10296,7291,8739,546,904,51,61,504,488,7,8,79,96,7076,8390,1402,1906
Travis,17,11777,4940,6837,4194,5773,382,595,24,50,293,364,6,3,41,52,4138,5582,802,1255
Travis,18,12913,4636,8277,4136,7258,277,637,15,36,190,299,4,0,14,47,3956,7027,680,1250
Trinity,5,649,315,334,262,283,34,37,2,4,1,4,0,0,16,6,276,280,39,54
Trinity,6,749,390,359,347,306,34,38,3,5,1,2,0,0,5,8,327,312,63,47
Trinity,7,678,329,349,291,307,33,34,0,4,0,2,0,1,5,1,278,302,51,47
Trinity,8,741,345,396,295,342,39,39,4,7,4,2,0,0,3,6,298,353,47,43
Trinity,9,702,349,353,294,323,42,25,5,3,4,0,0,0,4,2,298,298,51,55
Trinity,10,812,378,434,341,390,27,37,1,1,3,2,2,0,4,4,333,381,45,53
Trinity,11,893,442,451,379,409,54,40,1,0,1,1,1,0,6,1,400,412,42,39
Trinity,12,1154,514,640,457,547,43,71,4,6,1,4,0,0,9,12,487,618,27,22
Trinity,13,1202,503,699,444,605,41,69,6,9,3,3,0,1,9,12,478,665,25,34
Trinity,14,1237,591,646,528,580,52,51,1,4,1,4,0,0,9,7,564,618,27,28
Trinity,15,1015,539,476,508,427,23,36,3,8,0,2,0,0,5,3,519,469,20,7
Trinity,16,781,355,426,329,393,22,22,2,5,0,1,0,0,2,5,349,417,6,9
Trinity,17,483,235,248,218,230,12,15,3,1,0,1,0,0,2,1,220,243,15,5
Trinity,18,382,161,221,143,181,14,27,0,3,1,9,0,0,3,1,157,218,4,3
Tyler,5,1404,937,467,648,401,264,47,13,5,3,0,0,0,9,14,722,445,215,22
Tyler,6,1615,1129,486,807,418,296,49,18,5,2,3,0,1,6,10,855,458,274,28
Tyler,7,1321,870,451,635,389,215,49,9,5,3,5,1,0,7,3,682,425,188,26
Tyler,8,1283,735,548,562,485,160,45,3,8,3,3,0,0,7,7,604,508,131,40
Tyler,9,1192,688,504,571,457,107,39,0,3,6,3,0,0,4,2,601,476,87,28
Tyler,10,1164,615,549,522,494,72,39,5,9,1,1,0,0,15,6,567,525,48,24
Tyler,11,1291,657,634,572,563,67,56,5,4,3,5,1,0,9,6,609,617,48,17
Tyler,12,1456,687,769,628,684,45,65,5,2,1,9,0,0,8,9,647,755,40,14
Tyler,13,1474,748,726,670,634,59,67,9,6,4,7,0,1,6,11,731,716,17,10
Tyler,14,1401,683,718,640,658,29,48,3,2,2,0,1,0,8,10,663,702,20,16
Tyler,15,1256,584,672,553,624,20,38,5,1,2,2,1,0,3,7,571,667,13,5
Tyler,16,960,467,493,432,460,29,26,2,3,2,2,0,0,2,2,459,484,8,9
Tyler,17,641,311,330,279,300,22,25,4,3,0,1,1,0,5,1,301,324,10,6
Tyler,18,545,196,349,185,323,9,22,1,3,1,0,0,0,0,1,187,345,9,4
Upshur,5,2202,1194,1008,1020,864,112,88,16,18,10,5,0,1,36,32,1053,883,141,125
Upshur,6,2468,1185,1283,1012,1132,134,105,11,14,5,7,1,2,22,23,1055,1152,130,131
Upshur,7,2291,1119,1172,993,1064,88,74,14,9,5,11,1,0,18,14,984,1052,135,120
Upshur,8,2489,1237,1252,1121,1105,77,95,19,16,6,6,1,2,13,28,1067,1129,170,123
Upshur,9,2279,1126,1153,1013,1038,74,78,15,12,7,8,1,0,16,17,1005,1028,121,125
Upshur,10,2465,1205,1260,1066,1102,112,102,10,29,7,10,0,0,10,17,1119,1145,86,115
Upshur,11,2529,1236,1293,1084,1151,114,121,23,8,0,1,1,0,14,12,1133,1217,103,76
Upshur,12,3216,1543,1673,1391,1506,115,136,17,13,6,8,0,0,14,10,1455,1598,88,75
Upshur,13,2968,1472,1496,1331,1310,98,137,13,14,7,10,4,1,19,24,1428,1447,44,49
Upshur,14,2452,1176,1276,1039,1153,108,93,10,12,4,2,0,0,15,16,1146,1240,30,36
Upshur,15,2029,962,1067,861,957,81,91,5,11,0,4,0,0,15,4,932,1048,30,19
Upshur,16,1339,619,720,554,646,53,57,8,5,1,4,1,0,2,8,597,715,22,5
Upshur,17,962,451,511,399,452,39,48,7,3,1,2,0,0,5,6,446,502,5,9
Upshur,18,810,296,514,260,456,29,53,2,2,1,0,0,0,4,3,289,508,7,6
Upton,5,177,100,77,88,75,3,1,7,0,0,0,0,0,2,1,39,29,61,48
Upton,6,240,123,117,111,109,5,3,5,3,1,2,0,0,1,0,50,48,73,69
Upton,7,268,136,132,125,123,4,5,4,2,1,0,0,0,2,2,69,59,67,73
Upton,8,227,123,104,116,97,1,2,1,1,0,2,0,0,5,2,52,42,71,62
Upton,9,230,120,110,109,99,6,3,1,4,0,2,0,0,4,2,45,52,75,58
Upton,10,197,90,107,86,103,1,2,2,1,1,0,0,0,0,1,44,47,46,60
Upton,11,182,92,90,88,83,3,3,1,4,0,0,0,0,0,0,44,43,48,47
Upton,12,198,90,108,84,95,4,3,2,7,0,1,0,0,0,2,51,62,39,46
Upton,13,253,141,112,130,106,7,2,3,4,1,0,0,0,0,0,80,65,61,47
Upton,14,150,70,80,65,72,1,5,4,3,0,0,0,0,0,0,41,40,29,40
Upton,15,121,66,55,61,51,1,2,3,2,0,0,0,0,1,0,38,35,28,20
Upton,16,101,56,45,54,43,0,0,1,2,0,0,0,0,1,0,35,26,21,19
Upton,17,65,30,35,25,30,0,2,3,2,0,0,0,0,2,1,12,27,18,8
Upton,18,77,28,49,25,43,2,3,0,3,0,0,0,0,1,0,24,35,4,14
Uvalde,5,1879,967,912,919,871,14,13,16,9,7,16,0,0,11,3,191,164,776,748
Uvalde,6,1953,1031,922,974,878,27,16,15,12,6,8,0,2,9,6,222,194,809,728
Uvalde,7,1623,806,817,779,781,4,8,6,7,6,16,1,2,10,3,187,204,619,613
Uvalde,8,1487,734,753,705,719,6,3,12,13,5,7,1,1,5,10,189,184,545,569
Uvalde,9,1493,747,746,711,711,4,12,12,9,15,7,2,1,3,6,160,162,587,584
Uvalde,10,1517,709,808,671,774,5,8,17,9,9,14,1,0,6,3,180,232,529,576
Uvalde,11,1370,667,703,646,678,5,11,4,7,6,5,0,0,6,2,219,227,448,476
Uvalde,12,1423,661,762,619,738,20,9,9,7,5,5,1,1,7,2,266,271,395,491
Uvalde,13,1411,711,700,686,673,6,5,9,11,6,5,0,1,4,5,287,266,424,434
Uvalde,14,1250,556,694,535,670,6,8,12,7,1,3,0,0,2,6,228,281,328,413
Uvalde,15,1193,553,640,539,623,3,2,3,5,3,4,0,0,5,6,250,300,303,340
Uvalde,16,787,358,429,350,420,3,1,3,2,1,1,0,0,1,5,191,209,167,220
Uvalde,17,589,269,320,259,309,5,1,2,4,2,0,0,2,1,4,149,144,120,176
Uvalde,18,657,251,406,240,388,3,3,5,8,1,0,0,2,2,5,120,215,131,191
Val,5,4010,2315,1695,2120,1587,80,52,35,19,27,15,7,4,46,18,637,298,1678,1397
Val,6,3835,2159,1676,2023,1591,56,27,24,13,31,25,1,3,24,17,552,340,1607,1336
Val,7,3320,1852,1468,1726,1370,67,34,12,21,16,24,6,2,25,17,396,273,1456,1195
Val,8,3011,1564,1447,1470,1354,46,37,11,11,18,26,3,1,16,18,266,232,1298,1215
Val,9,2736,1380,1356,1312,1277,23,24,19,24,5,10,2,3,19,18,203,178,1177,1178
Val,10,2707,1343,1364,1283,1323,20,12,22,15,2,6,4,3,12,5,231,180,1112,1184
Val,11,2627,1339,1288,1287,1252,20,8,17,15,5,9,4,1,6,3,237,202,1102,1086
Val,12,2371,1112,1259,1060,1211,22,20,8,10,16,9,1,1,5,8,272,206,840,1053
Val,13,2030,921,1109,870,1068,26,15,13,9,6,16,1,1,5,0,225,252,696,857
Val,14,1982,921,1061,881,1026,21,15,8,4,6,7,0,3,5,6,265,233,656,828
Val,15,1813,852,961,816,936,16,10,10,5,4,6,1,0,5,4,274,219,578,742
Val,16,1309,625,684,603,663,11,7,4,7,1,4,1,1,5,2,159,161,466,523
Val,17,931,416,515,401,500,8,6,4,1,1,5,0,0,2,3,123,103,293,412
Val,18,942,370,572,356,558,5,5,4,3,0,2,0,0,5,4,75,117,295,455
Van,5,2900,1483,1417,1376,1308,51,29,10,13,8,5,3,27,35,35,1239,1172,244,245
Van,6,3073,1568,1505,1448,1401,54,46,23,20,11,11,2,2,30,25,1319,1306,249,199
Van,7,2918,1466,1452,1369,1364,45,49,21,17,12,4,1,0,18,18,1261,1263,205,189
Van,8,3139,1542,1597,1441,1510,53,45,16,15,8,9,0,2,24,16,1299,1389,243,208
Van,9,3163,1540,1623,1448,1534,43,42,17,14,7,14,1,0,24,19,1365,1431,175,192
Van,10,3587,1707,1880,1617,1790,50,34,18,17,6,18,3,2,13,19,1504,1699,203,181
Van,11,3583,1721,1862,1635,1771,51,45,15,16,5,11,0,3,15,16,1564,1709,157,153
Van,12,4154,2064,2090,1948,1961,65,70,20,20,7,17,0,2,24,20,1900,1965,164,125
Van,13,3909,1868,2041,1769,1933,54,63,19,14,7,9,2,0,17,22,1734,1954,134,87
Van,14,3485,1659,1826,1575,1732,40,55,24,15,8,6,1,1,11,17,1575,1769,84,57
Van,15,2967,1419,1548,1364,1485,30,27,11,10,4,11,1,0,9,15,1354,1511,65,37
Van,16,2157,985,1172,932,1123,21,23,17,14,0,2,0,1,15,9,971,1148,14,24
Van,17,1465,706,759,688,725,10,15,2,8,1,4,0,0,5,7,685,752,21,7
Van,18,1216,455,761,436,726,7,20,3,7,2,1,0,0,7,7,430,755,25,6
Victoria,5,5938,2989,2949,2577,2544,264,243,44,30,38,69,6,2,60,61,1379,1349,1610,1600
Victoria,6,6725,3431,3294,3069,2966,237,214,28,22,40,39,7,5,50,48,1645,1589,1786,1705
Victoria,7,6089,3092,2997,2763,2704,212,182,35,28,40,57,1,2,41,24,1481,1462,1611,1535
Victoria,8,6010,2979,3031,2647,2721,195,206,35,36,59,38,3,4,40,26,1491,1463,1488,1568
Victoria,9,5091,2515,2576,2264,2303,162,159,31,32,36,57,3,3,19,22,1284,1274,1231,1302
Victoria,10,4976,2378,2598,2129,2340,176,156,26,20,31,48,1,4,15,30,1306,1403,1072,1195
Victoria,11,5122,2463,2659,2226,2427,158,158,37,23,30,33,1,1,11,17,1417,1532,1046,1127
Victoria,12,5794,2812,2982,2557,2722,166,183,26,21,43,38,2,3,18,15,1742,1888,1070,1094
Victoria,13,5539,2658,2881,2421,2593,143,161,30,16,36,83,2,1,26,27,1737,1914,921,967
Victoria,14,4630,2157,2473,1939,2260,152,155,22,11,30,36,0,0,14,11,1448,1652,709,821
Victoria,15,3743,1731,2012,1602,1862,91,117,16,11,12,12,1,0,9,10,1175,1351,556,661
Victoria,16,2651,1165,1486,1089,1392,55,69,4,11,11,10,0,1,6,3,852,1046,313,440
Victoria,17,1893,801,1092,739,1020,39,46,12,13,5,8,0,0,6,5,559,762,242,330
Victoria,18,1903,685,1218,637,1120,32,80,3,2,3,11,2,0,8,5,517,924,168,294
Walker,5,10629,5419,5210,4073,3837,1154,1198,39,56,63,40,10,4,80,75,4312,4297,1107,913
Walker,6,5819,3728,2091,2392,1523,1181,451,43,22,48,46,5,5,59,44,2945,1612,783,479
Walker,7,5123,3512,1611,2375,1169,1025,369,32,7,41,42,5,5,34,19,2643,1292,869,319
Walker,8,4857,3288,1569,2215,1145,1015,362,8,10,26,28,0,2,24,22,2580,1284,708,285
Walker,9,4700,3333,1367,2209,995,1047,309,21,16,37,26,1,1,18,20,2722,1104,611,263
Walker,10,5188,3596,1592,2395,1198,1134,335,21,19,29,21,1,2,16,17,2998,1311,598,281
Walker,11,4770,3205,1565,2156,1200,984,315,29,15,17,21,3,2,16,12,2728,1312,477,253
Walker,12,4336,2546,1790,1817,1410,671,337,26,16,15,15,0,1,17,11,2176,1572,370,218
Walker,13,3775,2052,1723,1581,1388,425,275,16,24,18,24,2,1,10,11,1787,1535,265,188
Walker,14,3341,1705,1636,1393,1327,268,252,16,15,18,28,0,4,10,10,1532,1523,173,113
Walker,15,2384,1194,1190,1014,1006,155,154,8,6,7,15,0,1,10,8,1120,1127,74,63
Walker,16,1858,871,987,755,799,98,174,6,5,5,3,0,0,7,6,828,953,43,34
Walker,17,1034,449,585,409,494,36,86,2,2,0,1,0,0,2,2,420,560,29,25
Walker,18,1021,397,624,346,540,37,73,3,2,4,1,0,2,7,6,385,597,12,27
Waller,5,7406,3718,3688,1432,1546,2148,2056,28,26,45,25,2,2,63,33,2941,2908,777,780
Waller,6,3116,1641,1475,1099,1089,468,312,36,28,16,19,4,1,18,26,1110,949,531,526
Waller,7,2817,1433,1384,1173,1128,167,182,30,18,33,29,4,1,26,26,880,867,553,517
Waller,8,2975,1498,1477,1190,1189,215,214,31,20,38,33,1,1,23,20,897,950,601,527
Waller,9,2693,1396,1297,1175,1039,160,194,27,25,25,28,1,2,8,9,870,853,526,444
Waller,10,2782,1344,1438,1114,1178,171,203,19,26,28,21,2,1,10,9,889,959,455,479
Waller,11,2919,1451,1468,1210,1184,196,226,25,24,13,15,0,2,7,17,1021,1051,430,417
Waller,12,3045,1505,1540,1238,1259,218,226,18,23,16,24,1,0,14,8,1163,1242,342,298
Waller,13,2824,1435,1389,1172,1103,224,235,12,13,17,20,0,1,10,17,1142,1161,293,228
Waller,14,2152,1072,1080,881,855,154,192,20,16,9,10,1,2,7,5,904,964,168,116
Waller,15,1684,819,865,685,696,109,136,10,7,6,13,1,1,8,12,694,761,125,104
Waller,16,1129,546,583,437,466,84,102,11,3,8,7,0,2,6,3,486,533,60,50
Waller,17,612,269,343,215,259,45,82,7,1,1,1,1,0,0,0,238,315,31,28
Waller,18,676,276,400,210,299,54,88,2,5,3,2,1,0,6,6,249,361,27,39
Ward,5,703,372,331,337,293,21,20,5,8,4,7,0,0,5,3,142,122,230,209
Ward,6,827,433,394,387,346,15,24,8,10,2,3,2,3,19,8,175,171,258,223
Ward,7,803,444,359,388,331,39,14,10,3,3,1,0,0,4,10,172,154,272,205
Ward,8,872,447,425,412,385,22,21,2,6,1,6,0,0,10,7,195,208,252,217
Ward,9,610,328,282,303,264,18,10,3,3,1,2,0,0,3,3,138,134,190,148
Ward,10,652,336,316,309,302,7,9,11,3,4,1,0,0,5,1,157,134,179,182
Ward,11,632,313,319,270,302,29,8,6,5,2,2,1,0,5,2,157,145,156,174
Ward,12,721,351,370,324,345,16,15,8,8,0,1,0,0,3,1,192,190,159,180
Ward,13,600,301,299,280,273,7,14,6,4,2,4,1,0,5,4,177,167,124,132
Ward,14,506,224,282,209,258,9,16,3,2,3,2,0,1,0,3,115,163,109,119
Ward,15,417,195,222,189,203,3,12,1,4,0,0,0,0,2,3,117,117,78,105
Ward,16,273,127,146,113,136,8,8,3,1,1,0,0,0,2,1,74,101,53,45
Ward,17,213,94,119,86,113,4,4,3,2,1,0,0,0,0,0,54,74,40,45
Ward,18,225,86,139,78,134,5,4,3,0,0,0,0,0,0,1,50,95,36,44
Washington,5,2251,1162,1089,779,766,328,246,8,12,21,42,2,0,24,23,942,844,220,245
Washington,6,1798,887,911,674,656,174,214,3,10,20,21,1,0,15,10,691,749,196,162
Washington,7,1895,942,953,755,722,161,199,7,7,11,20,0,1,8,4,708,774,234,179
Washington,8,1830,889,941,747,724,115,181,2,5,14,24,2,0,9,7,679,742,210,199
Washington,9,1822,900,922,703,683,160,158,7,8,18,66,1,0,11,7,699,752,201,170
Washington,10,1864,934,930,760,750,141,140,6,4,21,30,0,0,6,6,747,808,187,122
Washington,11,2020,988,1032,787,827,153,173,7,4,34,24,1,0,6,4,869,931,119,101
Washington,12,2439,1209,1230,979,985,201,211,5,5,15,21,1,1,8,7,1086,1135,123,95
Washington,13,2512,1173,1339,958,1112,174,193,11,2,19,22,1,0,10,10,1094,1253,79,86
Washington,14,2191,1072,1119,925,951,132,147,5,5,6,9,0,0,4,7,1016,1063,56,56
Washington,15,1835,885,950,772,800,93,138,2,2,15,6,0,0,3,4,845,911,40,39
Washington,16,1424,649,775,562,677,75,85,1,2,10,4,0,1,1,6,629,755,20,20
Washington,17,937,390,547,360,484,26,62,1,0,2,1,0,0,1,0,380,533,10,14
Washington,18,1273,446,827,400,738,39,74,1,2,2,4,1,3,3,6,439,809,7,18
Webb,5,21854,10968,10886,10686,10667,90,67,56,63,76,43,5,8,55,38,382,347,10586,10539
Webb,6,20013,10213,9800,9937,9562,93,60,66,58,60,79,3,2,54,39,512,374,9701,9426
Webb,7,17239,8750,8489,8488,8280,86,41,71,65,61,70,5,9,39,24,513,380,8237,8109
Webb,8,17421,8715,8706,8445,8513,101,53,62,52,71,60,12,4,24,24,516,349,8199,8357
Webb,9,17483,8557,8926,8316,8693,71,58,57,73,80,76,5,4,28,22,402,288,8155,8638
Webb,10,17207,8267,8940,8040,8744,80,45,53,62,65,63,8,5,21,21,453,325,7814,8615
Webb,11,14427,6728,7699,6511,7522,66,27,45,65,77,54,4,4,25,27,374,287,6354,7412
Webb,12,12803,6135,6668,5994,6539,49,21,28,33,49,50,1,3,14,22,389,359,5746,6309
Webb,13,10992,4995,5997,4864,5883,39,34,29,20,37,43,4,0,22,17,414,374,4581,5623
Webb,14,8425,3829,4596,3735,4502,29,29,24,20,32,30,0,2,9,13,417,406,3412,4190
Webb,15,6815,3078,3737,2993,3679,23,12,20,15,26,18,2,1,14,12,401,307,2677,3430
Webb,16,4596,2002,2594,1961,2562,10,9,11,11,11,6,1,1,8,5,236,171,1766,2423
Webb,17,3008,1172,1836,1147,1813,4,7,13,8,5,6,0,0,3,2,95,73,1077,1763
Webb,18,3055,1098,1957,1074,1925,7,6,7,11,7,7,0,3,3,5,97,116,1001,1841
Wharton,5,2627,1357,1270,1127,1028,198,207,11,3,5,17,2,2,14,13,651,637,706,633
Wharton,6,2593,1339,1254,1117,1012,200,206,6,7,6,14,0,1,10,14,703,676,636,578
Wharton,7,2520,1256,1264,1060,1064,169,172,12,12,7,6,1,2,7,8,649,657,607,607
Wharton,8,2529,1208,1321,1023,1087,152,203,16,12,6,7,0,1,11,11,670,747,538,574
Wharton,9,2221,1092,1129,947,952,125,150,7,9,7,9,0,0,6,9,624,605,468,524
Wharton,10,2254,1107,1147,943,992,143,137,6,7,10,6,1,0,4,5,633,671,474,476
Wharton,11,2521,1244,1277,1084,1082,141,176,13,6,2,5,0,0,4,8,736,781,508,496
Wharton,12,2708,1341,1367,1122,1134,190,208,18,11,3,7,3,1,5,6,893,975,448,392
Wharton,13,2655,1276,1379,1082,1165,165,186,12,11,9,7,1,1,7,9,903,1007,373,372
Wharton,14,2343,1179,1164,1016,980,140,163,6,9,10,6,0,0,7,6,868,880,311,284
Wharton,15,1587,748,839,643,717,89,108,7,6,4,5,0,0,5,3,587,672,161,167
Wharton,16,1253,550,703,462,588,80,107,4,6,1,0,0,0,3,2,445,551,105,152
Wharton,17,967,383,584,328,493,50,87,2,2,0,0,0,1,3,1,324,470,59,114
Wharton,18,914,331,583,286,521,38,52,1,6,1,1,0,1,5,2,264,475,67,108
Wheeler,5,277,137,140,125,123,6,7,3,3,0,2,0,0,3,5,87,98,50,42
Wheeler,6,302,155,147,139,133,5,6,1,2,1,0,0,0,9,6,115,100,40,47
Wheeler,7,272,135,137,126,124,5,10,2,3,1,0,0,0,1,0,95,105,40,32
Wheeler,8,322,153,169,144,159,4,2,5,2,0,2,0,0,0,4,99,117,54,52
Wheeler,9,282,143,139,133,128,7,3,2,5,1,2,0,0,0,1,94,99,49,40
Wheeler,10,294,138,156,135,146,2,2,1,6,0,1,0,0,0,1,96,96,42,60
Wheeler,11,268,144,124,124,117,17,3,1,3,0,0,0,0,2,1,116,95,28,29
Wheeler,12,377,179,198,164,188,10,5,3,2,0,2,0,0,2,1,155,166,24,32
Wheeler,13,372,185,187,180,173,2,5,3,5,0,2,0,0,0,2,169,173,16,14
Wheeler,14,287,152,135,143,128,3,1,2,1,0,4,0,0,4,1,132,128,20,7
Wheeler,15,274,136,138,130,130,0,3,2,0,3,3,0,0,1,2,125,126,11,12
Wheeler,16,196,88,108,84,99,2,1,0,2,1,2,0,0,1,4,81,105,7,3
Wheeler,17,133,58,75,53,74,2,0,0,0,3,1,0,0,0,0,54,71,4,4
Wheeler,18,111,46,65,42,64,2,0,0,1,0,0,0,0,2,0,40,59,6,6
Wichita,5,11800,7090,4710,5482,3624,1079,712,101,84,189,121,14,6,225,163,5620,3617,1470,1093
Wichita,6,10455,5706,4749,4538,3776,846,669,78,62,116,95,12,6,116,141,4470,3789,1236,960
Wichita,7,9419,5097,4322,4125,3571,703,464,62,59,93,111,5,9,109,108,3876,3415,1221,907
Wichita,8,8376,4450,3926,3580,3305,633,384,53,50,85,90,14,9,85,88,3388,3105,1062,821
Wichita,9,6911,3718,3193,3031,2681,494,303,36,48,90,93,7,4,60,64,2876,2598,842,595
Wichita,10,7011,3675,3336,2984,2784,482,316,58,52,90,119,6,4,55,61,3027,2749,648,587
Wichita,11,7167,3607,3560,2992,3046,453,310,49,47,79,115,0,6,34,36,3004,3017,603,543
Wichita,12,8327,4152,4175,3576,3597,379,344,78,74,69,116,8,3,42,41,3582,3647,570,528
Wichita,13,7744,3760,3984,3301,3502,315,307,38,46,58,96,2,0,46,33,3304,3599,456,385
Wichita,14,6060,2891,3169,2556,2750,227,265,32,47,43,70,2,6,31,31,2590,2855,301,314
Wichita,15,4567,2087,2480,1878,2192,128,178,25,29,36,52,1,1,19,28,1884,2263,203,217
Wichita,16,3419,1418,2001,1297,1775,81,161,13,14,16,34,0,1,11,16,1310,1834,108,167
Wichita,17,2609,1045,1564,958,1410,54,97,12,19,15,29,0,1,6,8,960,1452,85,112
Wichita,18,2730,912,1818,841,1670,55,105,7,10,2,20,0,1,7,12,862,1721,50,97
Wilbarger,5,804,441,363,339,295,53,38,9,6,24,12,1,1,15,11,307,236,134,127
Wilbarger,6,851,427,424,348,361,33,31,6,6,32,20,0,1,8,5,276,268,151,156
Wilbarger,7,892,412,480,354,400,30,47,8,8,13,15,0,0,7,10,242,316,170,164
Wilbarger,8,764,387,377,335,315,27,34,3,12,13,9,1,0,8,7,259,253,128,124
Wilbarger,9,715,352,363,301,317,34,25,3,5,12,10,0,0,2,6,243,233,109,130
Wilbarger,10,737,364,373,292,315,45,34,8,8,15,7,0,1,4,8,263,276,101,97
Wilbarger,11,710,373,337,331,291,21,24,7,5,8,13,0,0,6,4,258,243,115,94
Wilbarger,12,907,433,474,376,422,36,26,9,11,6,4,0,0,6,11,325,373,108,101
Wilbarger,13,851,425,426,360,374,50,33,5,6,6,8,0,0,4,5,345,351,80,75
Wilbarger,14,691,349,342,308,312,29,20,3,2,4,5,0,0,5,3,292,284,57,58
Wilbarger,15,611,280,331,253,300,14,19,5,6,3,3,0,0,5,3,225,288,55,43
Wilbarger,16,425,189,236,177,219,5,11,3,2,2,3,0,0,2,1,162,217,27,19
Wilbarger,17,305,130,175,119,161,7,9,2,1,2,1,0,0,0,3,114,161,16,14
Wilbarger,18,330,108,222,98,204,6,12,1,2,2,1,0,0,1,3,101,200,7,22
Willacy,5,2068,1367,701,1229,669,92,13,9,2,31,5,0,1,6,11,191,61,1176,640
Willacy,6,1914,1233,681,1123,653,82,16,8,5,19,4,0,1,1,2,167,52,1066,629
Willacy,7,1546,987,559,912,539,51,9,10,5,12,3,2,0,0,3,104,45,883,514
Willacy,8,1512,993,519,919,493,47,12,7,8,14,3,1,0,5,3,136,44,857,475
Willacy,9,1316,760,556,721,535,22,9,7,8,9,2,0,0,1,2,75,30,685,526
Willacy,10,1153,625,528,582,510,27,3,1,7,9,5,3,1,3,2,89,45,536,483
Willacy,11,1094,570,524,537,514,26,4,2,0,4,4,0,0,1,2,91,51,479,473
Willacy,12,1035,497,538,486,529,6,4,0,2,1,3,0,0,4,0,70,63,427,475
Willacy,13,1006,462,544,444,536,10,2,3,4,4,2,0,0,1,0,70,88,392,456
Willacy,14,915,422,493,410,480,5,4,4,5,2,0,0,0,1,4,70,70,352,423
Willacy,15,752,372,380,363,373,5,4,3,2,0,0,0,0,1,1,81,64,291,316
Willacy,16,588,249,339,239,331,5,3,5,3,0,0,0,0,0,2,81,80,168,259
Willacy,17,351,166,185,161,180,3,1,1,0,0,0,0,0,1,4,43,33,123,152
Willacy,18,408,142,266,139,263,0,0,1,2,0,0,0,1,2,0,33,60,109,206
Williamson,5,31279,15632,15647,12517,12620,1374,1335,177,168,912,919,26,24,626,581,10363,10371,5269,5276
Williamson,6,36156,17972,18184,14209,14428,1790,1624,210,181,1226,1424,45,23,492,504,12703,12746,5269,5438
Williamson,7,42893,21094,21799,16802,17161,1653,1581,209,177,1921,2345,50,24,459,511,15044,15997,6050,5802
Williamson,8,47594,23381,24213,18462,18596,1731,1806,175,205,2485,2983,43,33,485,590,17138,17997,6243,6216
Williamson,9,44913,22507,22406,17472,17617,1656,1644,232,203,2710,2451,32,33,405,458,17034,16750,5473,5656
Williamson,10,42244,21150,21094,17219,17237,1513,1590,215,169,1837,1721,28,45,338,332,16485,16014,4665,5080
Williamson,11,34570,17265,17305,14516,14355,1274,1418,150,150,1062,1124,30,31,233,227,13698,13611,3567,3694
Williamson,12,31987,15508,16479,13249,14163,1147,1179,133,137,761,745,22,22,196,233,12847,13578,2661,2901
Williamson,13,27272,12706,14566,11077,12584,818,977,103,106,550,725,16,14,142,160,10858,12370,1848,2196
Williamson,14,23537,10565,12972,9386,11383,513,742,77,69,480,656,17,13,92,109,9279,11373,1286,1599
Williamson,15,19183,8725,10458,7860,9442,281,381,42,57,450,489,7,11,85,78,7929,9371,796,1087
Williamson,16,12117,5560,6557,5089,6022,133,186,39,30,260,283,7,6,32,30,5126,5901,434,656
Williamson,17,7311,3241,4070,2977,3750,70,109,13,31,160,158,2,3,19,19,2910,3602,331,468
Williamson,18,6618,2343,4275,2199,3986,56,142,15,20,51,96,2,6,20,25,2166,3896,177,379
Wilson,5,2855,1459,1396,1374,1307,32,29,22,12,8,8,3,2,20,38,744,707,715,689
Wilson,6,2814,1469,1345,1403,1253,32,33,13,23,8,14,4,2,9,20,749,723,720,622
Wilson,7,2912,1421,1491,1371,1416,29,19,6,20,8,10,0,0,7,26,810,886,611,605
Wilson,8,3218,1619,1599,1560,1527,19,15,8,18,9,11,1,1,22,27,935,942,684,657
Wilson,9,2938,1493,1445,1413,1396,27,11,21,16,14,12,0,1,18,9,857,829,636,616
Wilson,10,3543,1744,1799,1663,1717,31,29,22,20,9,17,0,3,19,13,1085,1052,659,747
Wilson,11,3534,1754,1780,1661,1689,49,27,21,25,5,11,1,2,17,26,1084,1113,670,667
Wilson,12,3747,1871,1876,1781,1788,35,44,21,14,6,11,6,1,22,18,1288,1232,583,644
Wilson,13,3296,1635,1661,1554,1589,49,33,16,12,3,12,1,1,12,14,1097,1103,538,558
Wilson,14,2794,1377,1417,1322,1358,35,21,10,12,0,15,2,0,8,11,959,1004,418,413
Wilson,15,2072,1028,1044,983,1003,24,15,4,12,9,8,0,0,8,6,757,741,271,303
Wilson,16,1371,681,690,654,659,11,8,9,6,2,9,0,0,5,8,500,495,181,195
Wilson,17,859,396,463,385,442,7,9,1,4,0,3,0,1,3,4,303,324,93,139
Wilson,18,898,366,532,348,512,9,7,3,4,1,1,0,0,5,8,264,387,102,145
Winkler,5,508,280,228,256,202,11,9,4,7,2,2,0,0,7,8,95,69,185,159
Winkler,6,517,266,251,246,237,8,2,5,4,1,3,2,0,4,5,88,91,178,160
Winkler,7,509,277,232,258,211,9,12,5,6,0,1,0,0,5,2,82,95,195,137
Winkler,8,501,274,227,253,211,6,8,11,5,3,1,0,0,1,2,89,82,185,145
Winkler,9,507,256,251,232,236,16,5,2,5,3,3,0,0,3,2,92,69,164,182
Winkler,10,448,237,211,218,195,10,5,5,9,3,1,0,0,1,1,98,87,139,124
Winkler,11,449,245,204,225,194,13,6,3,3,3,1,0,0,1,0,111,101,134,103
Winkler,12,476,268,208,256,198,9,3,3,6,0,0,0,0,0,1,126,98,142,110
Winkler,13,372,182,190,169,177,5,10,6,2,0,1,0,0,2,0,99,106,83,84
Winkler,14,292,143,149,133,142,6,2,2,3,1,1,0,0,1,1,79,81,64,68
Winkler,15,267,107,160,104,151,0,2,2,4,0,1,0,0,1,2,54,91,53,69
Winkler,16,153,71,82,65,79,2,1,1,1,3,0,0,0,0,1,38,48,33,34
Winkler,17,130,57,73,56,68,0,2,0,1,0,0,0,0,1,2,41,52,16,21
Winkler,18,99,39,60,37,55,0,4,1,1,0,0,0,0,1,0,18,43,21,17
Wise,5,3706,1900,1806,1780,1710,44,32,28,25,14,9,1,0,33,30,1379,1317,521,489
Wise,6,4123,2056,2067,1929,1956,49,28,29,26,13,12,4,2,32,43,1530,1606,526,461
Wise,7,4247,2150,2097,1999,1976,61,40,28,31,15,17,4,0,43,33,1591,1604,559,493
Wise,8,4451,2254,2197,2116,2095,82,30,21,13,14,22,2,2,19,35,1745,1685,509,512
Wise,9,4058,2028,2030,1919,1933,53,34,18,28,17,17,0,3,21,15,1549,1625,479,405
Wise,10,4578,2268,2310,2139,2202,48,26,28,32,11,23,1,0,41,27,1867,1905,401,405
Wise,11,4721,2367,2354,2238,2263,50,19,34,25,24,26,2,2,19,19,1988,2019,379,335
Wise,12,5190,2582,2608,2493,2498,28,31,27,37,18,12,2,4,14,26,2266,2301,316,307
Wise,13,4501,2265,2236,2182,2152,21,11,17,29,10,10,2,1,33,33,2026,2060,239,176
Wise,14,3323,1625,1698,1589,1639,10,14,7,18,3,8,0,0,16,19,1487,1574,138,124
Wise,15,2826,1428,1398,1387,1368,3,4,15,13,5,5,3,0,15,8,1332,1316,96,82
Wise,16,1953,911,1042,887,1012,6,6,7,9,4,5,0,0,7,10,866,975,45,67
Wise,17,1170,542,628,527,615,1,1,6,3,1,3,0,1,7,5,514,590,28,38
Wise,18,875,347,528,330,508,1,5,5,4,5,2,0,0,6,9,329,500,18,28
Wood,5,2585,1372,1213,1021,874,306,284,11,16,5,9,0,0,29,30,1172,1000,200,213
Wood,6,2243,1204,1039,1070,950,87,55,19,18,3,4,0,0,25,12,995,863,209,176
Wood,7,2071,1045,1026,922,954,83,37,15,14,13,9,4,1,8,11,883,896,162,130
Wood,8,2164,1099,1065,984,977,76,48,17,15,8,14,1,1,13,10,948,932,151,133
Wood,9,2039,1017,1022,951,956,42,31,8,12,8,9,1,0,7,14,888,924,129,98
Wood,10,2438,1266,1172,1191,1117,39,19,16,18,10,11,0,0,10,7,1115,1060,151,112
Wood,11,2699,1309,1390,1210,1310,72,50,14,11,6,5,1,0,6,14,1156,1297,153,93
Wood,12,3315,1598,1717,1501,1604,63,61,10,29,12,7,0,1,12,15,1494,1617,104,100
Wood,13,3656,1754,1902,1652,1805,69,58,15,18,6,8,0,1,12,12,1679,1821,75,81
Wood,14,3636,1711,1925,1642,1814,42,56,14,23,5,13,0,0,8,19,1653,1869,58,56
Wood,15,3359,1653,1706,1582,1640,36,43,9,3,5,9,1,2,20,9,1604,1673,49,33
Wood,16,2457,1172,1285,1120,1232,31,34,8,7,5,3,0,3,8,6,1138,1249,34,36
Wood,17,1491,715,776,675,738,24,19,10,6,0,1,0,0,6,12,691,756,24,20
Wood,18,1233,449,784,420,742,12,32,6,4,0,1,0,0,11,5,433,778,16,6
Yoakum,5,572,332,240,311,231,8,2,5,2,0,1,1,0,7,4,71,62,261,178
Yoakum,6,521,303,218,287,210,5,3,9,1,0,1,0,0,2,3,71,53,232,165
Yoakum,7,557,293,264,270,254,10,4,6,0,4,4,0,0,3,2,83,63,210,201
Yoakum,8,548,244,304,233,284,2,7,5,6,3,4,1,0,0,3,64,102,180,202
Yoakum,9,493,261,232,243,218,3,6,8,5,2,1,1,0,4,2,82,68,179,164
Yoakum,10,416,194,222,185,211,3,3,1,5,3,1,0,0,2,2,69,81,125,141
Yoakum,11,440,225,215,211,205,2,2,9,4,0,1,0,0,3,3,78,70,147,145
Yoakum,12,500,264,236,247,226,6,5,8,3,2,1,0,0,1,1,116,123,148,113
Yoakum,13,442,220,222,210,211,5,5,5,3,0,0,0,0,0,3,114,119,106,103
Yoakum,14,320,148,172,141,163,2,0,4,8,0,1,0,0,1,0,66,98,82,74
Yoakum,15,265,140,125,136,121,1,0,1,1,1,1,0,0,1,2,89,76,51,49
Yoakum,16,194,100,94,97,87,1,1,1,3,0,0,0,0,1,3,60,63,40,31
Yoakum,17,117,45,72,44,72,0,0,1,0,0,0,0,0,0,0,28,55,17,17
Yoakum,18,116,37,79,33,74,0,1,4,2,0,0,0,0,0,2,19,60,18,19
Young,5,904,491,413,457,382,10,3,12,17,7,6,1,0,4,5,354,303,137,110
Young,6,1014,486,528,452,492,13,13,10,5,1,6,1,3,9,9,362,422,124,106
Young,7,1061,530,531,494,506,12,8,11,3,6,6,1,0,6,8,390,405,140,126
Young,8,1017,503,514,483,494,12,6,2,7,3,4,0,1,3,2,371,402,132,112
Young,9,985,470,515,441,497,12,3,10,10,5,1,0,0,2,4,369,425,101,90
Young,10,997,499,498,476,479,9,3,9,7,1,5,0,0,4,4,413,424,86,74
Young,11,1079,566,513,539,489,11,11,11,5,1,2,0,1,4,5,470,432,96,81
Young,12,1275,628,647,599,619,14,9,6,11,7,2,0,0,2,6,536,566,92,81
Young,13,1250,633,617,611,595,4,8,5,6,11,5,0,1,2,2,561,565,72,52
Young,14,1150,572,578,547,541,4,6,8,8,9,18,0,0,4,5,534,530,38,48
Young,15,896,409,487,393,471,6,7,3,3,1,1,0,0,6,5,395,469,14,18
Young,16,670,302,368,294,360,1,4,3,1,0,0,0,0,4,3,284,361,18,7
Young,17,482,208,274,198,259,8,6,0,3,0,2,0,0,2,4,198,267,10,7
Young,18,492,174,318,168,311,2,0,1,1,2,1,0,0,1,5,169,302,5,16
Zapata,5,1029,527,502,519,490,2,3,3,3,3,4,0,0,0,2,16,14,511,488
Zapata,6,936,454,482,450,475,1,3,1,2,1,2,0,0,1,0,17,16,437,466
Zapata,7,827,409,418,402,416,2,0,3,2,0,0,0,0,2,0,14,9,395,409
Zapata,8,806,399,407,392,405,4,1,2,0,0,1,0,0,1,0,12,10,387,397
Zapata,9,880,420,460,417,452,0,1,3,6,0,1,0,0,0,0,16,13,404,447
Zapata,10,750,342,408,331,403,0,0,4,2,4,3,0,0,3,0,15,14,327,394
Zapata,11,739,321,418,316,413,2,1,2,2,1,1,0,0,0,1,13,14,308,404
Zapata,12,651,324,327,320,322,1,1,1,0,1,2,0,0,1,2,28,26,296,301
Zapata,13,588,305,283,296,280,3,0,3,0,0,0,0,0,3,3,27,20,278,263
Zapata,14,558,256,302,252,291,3,2,1,8,0,1,0,0,0,0,46,41,210,261
Zapata,15,462,195,267,193,263,2,0,0,2,0,1,0,0,0,1,21,36,174,231
Zapata,16,388,193,195,192,193,0,0,1,0,0,1,0,0,0,1,31,42,162,153
Zapata,17,236,123,113,122,112,1,1,0,0,0,0,0,0,0,0,37,32,86,81
Zapata,18,194,80,114,78,111,0,0,1,2,1,1,0,0,0,0,29,36,51,78
Zavala,5,1004,586,418,564,398,10,6,6,9,1,1,2,2,3,2,32,16,554,402
Zavala,6,917,510,407,498,390,5,4,2,7,3,0,1,0,1,6,23,27,487,380
Zavala,7,707,370,337,357,326,5,3,4,4,1,0,1,0,2,4,22,16,348,321
Zavala,8,649,313,336,299,327,4,2,4,4,1,1,0,1,5,1,18,25,295,311
Zavala,9,716,409,307,397,300,3,2,7,3,1,0,0,1,1,1,22,17,387,290
Zavala,10,640,315,325,301,315,4,4,5,4,2,0,1,1,2,1,26,16,289,309
Zavala,11,592,271,321,266,310,2,4,1,7,1,0,0,0,1,0,13,19,258,302
Zavala,12,583,293,290,286,284,3,1,4,3,0,1,0,0,0,1,13,15,280,275
Zavala,13,562,267,295,248,288,5,2,9,2,0,0,1,0,4,3,25,26,242,269
Zavala,14,579,266,313,254,305,6,1,2,3,1,2,0,1,3,1,20,21,246,292
Zavala,15,424,191,233,188,229,0,0,2,1,1,1,0,1,0,1,21,18,170,215
Zavala,16,285,131,154,130,152,0,0,0,1,1,0,0,0,0,1,14,12,117,142
Zavala,17,192,77,115,74,114,1,0,2,0,0,1,0,0,0,0,10,13,67,102
Zavala,18,210,86,124,85,124,0,0,0,0,0,0,0,0,1,0,10,10,76,114
